Incoming Attempts,Normal Term Seizures,Answered Calls,Normal Not Answer Calls,Outgoing Seizures,FEV Seizures,Network Conversation Minutes,NER,ACD
171,51,19,32,52,1,30.833333,100,1.622807
1,44,31,13,44,0,0.033333,100,0.001075258
456601,440591,97563,343028,453573,3648,584245.1667,97.92543202,5.988388699
41,41,40,1,41,0,14.533333,100,0.363333325
239,49,11,38,71,14,36.666667,85.96491228,3.333333364
8019,459,188,271,643,103,1435.066667,85,7.633333335
10,8,8,0,8,0,13.133333,100,1.641666625
995717,810191,219605,590586,826539,14677,305785.55,99.79417684,1.392434371
697441,495671,132245,363426,599515,18633,424442.05,85.33075564,3.209513025
1826,8250,5360,2890,8373,65,102.3,99.30187771,0.019085821
160630,46149,13141,33008,150549,70414,17189.43333,57.58906845,1.308076504
117,96,13,83,112,4,64.016667,88.88888889,4.924359
4214,1528,612,916,2300,446,3424.033333,82.41639698,5.594825708
50975,27686,12299,15387,28910,856,30424.88333,98.6882441,2.47376887
131312,104979,39559,65420,126730,11335,133433.5,90.97361237,3.373025102
2312,1310,727,583,1481,132,81.716667,97.10896961,0.112402568
5522,1173,362,811,1425,240,250.7,98.98734177,0.692541436
5146,1,1,0,1,0,1.083333,100,1.083333
503,369,92,277,387,4,275.7,96.34464752,2.99673913
8252,5697,2106,3591,5873,84,6721.85,98.41077906,3.191761633
9,4,3,1,4,0,28.25,100,9.416666667
274936,229366,126229,103137,234617,3008,136560.1,99.0315575,1.081844109
854477,734010,129831,604179,791004,32988,354766.0333,96.83304838,2.732521765
1305,4285,3184,1101,4370,26,250.55,98.64180479,0.078690327
6,2,2,0,6,4,2.716667,100,1.3583335
51423,28082,15723,12359,30212,2065,12126.01667,99.76906953,0.771227925
80,26,10,16,26,0,53.816667,100,5.3816667
346,224,131,93,234,8,586.2,99.11504425,4.47480916
24390,14470,7224,7246,18045,6,59334.08333,80.21508953,8.213466685
47473,26892,13690,13202,29933,7,134475.6333,89.86165876,9.822909666
263,134,126,8,140,2,31.933333,97.10144928,0.253439151
2540,1593,966,627,1661,17,4047.9,96.89781022,4.190372671
39,16,10,6,18,2,110.95,100,11.095
863,474,209,265,536,36,631.633333,94.8,3.022169057
1187,272,109,163,1015,32,597.916667,27.67039674,5.485474009
46222,11335,3309,8026,30016,331,9058.45,38.18426815,2.737518888
37,26,5,21,28,2,0.45,100,0.09
649,473,373,100,492,19,164.95,100,0.442225201
310,3,3,0,3,0,1.833333,100,0.611111
824,900,284,616,936,17,389.1,97.93253536,1.370070423
2820,1260,451,809,1992,43,1916.1,64.64853771,4.248558758
186317,93362,41646,51716,150343,39891,35488.23333,84.52721544,0.852140262
409492,326101,128939,197162,350736,10268,337000.4667,95.78022017,2.613642627
388,2755,1177,1578,3441,22,110.366667,80.5791167,0.093769471
60683,47412,27858,19554,60180,12617,14178.5,99.68252633,0.508956135
318,3,1,2,24,0,0.183333,12.5,0.183333
640,186,86,100,226,0,325.383333,82.30088496,3.783527128
13189,1879,1093,786,1964,5,1787.566667,95.91628382,1.635468131
30678,17777,8295,9482,32970,189,19183.23333,54.22958421,2.31262608
249,274,257,17,274,0,65.783333,100,0.255966276
1123,449,360,89,545,87,48.583333,98.0349345,0.134953703
73,18,4,14,26,8,0.5,100,0.125
533,197,4,193,208,0,4.316667,94.71153846,1.07916675
1012,497,314,183,615,21,1360.5,83.67003367,4.332802548
2112,552,215,337,606,54,1211.933333,100,5.636899223
94678,93065,26081,66984,113993,7809,102544.2167,87.64503127,3.931759391
2,31,18,13,43,8,0.133333,88.57142857,0.007407389
807,322,252,70,674,351,159.066667,99.69040248,0.631216933
1125,1,1,0,3,2,5.25,100,5.25
15593,15260,14697,563,15471,121,4553.583333,99.41368078,0.309830804
134874,71707,60281,11426,114326,28642,428157.0167,83.68773633,7.102686032
713343,500591,209479,291112,727892,115131,897056.5167,81.69433107,4.282321935
2600214,1418920,663529,755391,2453262,804965,1543255.65,86.08400064,2.325829994
5158,5198,4034,1164,5836,535,450.6,98.05697038,0.111700545
38,14,9,5,21,5,23.283333,87.5,2.587037
195,47,5,42,196,24,0.9,27.3255814,0.18
550221,190310,29760,160550,318596,121203,30289.85,96.41172686,1.017804099
85,59,40,19,84,10,116.066667,79.72972973,2.901666675
1595,1024,524,500,1350,78,2537.433333,80.50314465,4.842430025
5467,2915,1635,1280,5786,1318,5663.45,65.24171889,3.463883792
372991,302731,81300,221431,397306,23595,199676.0833,81.00671374,2.456040385
1026,4372,1076,3296,5489,463,156.75,86.98766415,0.145678439
8350,5033,2858,2175,6836,1750,2218.683333,98.95792371,0.776306275
31,13,10,3,13,0,34.883333,100,3.4883333
2088,1073,733,340,1087,10,2753.7,99.62859796,3.75675307
7516,2909,1641,1268,3186,274,5005.6,99.89697802,3.050335161
117601,37690,27405,10285,38958,955,39438.33333,99.17638081,1.439092623
275,270,261,9,270,0,65.583333,100,0.251277138
617,161,130,31,287,123,59.183333,98.17073171,0.455256408
1,1,1,0,1,0,0.266667,100,0.266667
51717,3421,2303,1118,3555,44,1806.866667,97.43662774,0.78457085
2,12,8,4,12,0,0.133333,100,0.016666625
145,49,31,18,76,27,2.716667,100,0.087634419
4802595,3149114,2595802,553312,4701688,1443039,689671.7167,96.63863767,0.265687335
242098,257230,193164,64066,265067,2693,111201.6,98.03943988,0.57568491
1357460,1185322,1034636,150686,1266629,54280,4649564.9,97.77069144,4.493913705
25,13,12,1,16,2,65.983333,92.85714286,5.498611083
436698,238858,150538,88320,261770,20944,289875.1,99.18281249,1.925594202
7127417,6205132,3395536,2809596,6811717,457277,5496479.5,97.65033583,1.618736924
22800,40068,22166,17902,43255,1916,128969.8167,96.92542151,5.818362206
103486,105035,85435,19600,110404,98,643004.8,95.22147481,7.526245684
254409,204836,145051,59785,221852,11709,445553.05,97.47457684,3.071699264
1730,483,93,390,875,1,39.733333,55.26315789,0.42724014
71910,81949,64723,17226,84247,1429,141144.1667,98.9507112,2.180742034
1,95,85,10,95,0,0,100,0
9612,8,1,7,8,0,0.65,100,0.65
61646,60992,60450,542,61371,232,13012.93333,99.75956427,0.215267714
546757,519223,508483,10740,530502,8622,858281.9333,99.49087913,1.687926506
495205,375048,264536,110512,429602,32846,800106.3167,94.52862717,3.024564962
55389,22859,15614,7245,32829,5199,92996.45,82.7325371,5.9559658
1216526,747151,376051,371100,1274957,450697,888175.1333,90.64506345,2.361847551
2923,81509,2245,79264,83570,1096,203.5,98.82993428,0.09064588
2836,2207,1970,237,2956,416,2840.766667,86.88976378,1.442013537
14095,10360,3760,6600,12245,935,1965.016667,91.60035367,0.522610816
80,14,5,9,21,4,18.733333,82.35294118,3.7466666
10038,7892,4601,3291,9447,59,25111.6,84.06476353,5.457856988
7500,3058,998,2060,3262,180,2488.016667,99.22128488,2.493002672
238271,180690,45850,134840,207345,13005,92681.03333,92.97622723,2.021396583
920,1095,918,177,1179,11,148.833333,93.75,0.162127814
5081,3647,1837,1810,3930,263,1389.4,99.45459504,0.756341862
628,583,499,84,598,14,863.25,99.82876712,1.72995992
12058,9865,2197,7668,10006,110,6721.45,99.68674212,3.059376422
832,697,276,421,787,90,587.983333,100,2.130374395
44605,40652,18687,21965,42865,2141,50128.65,99.82320008,2.682541339
254,295,281,14,296,1,70.333333,100,0.250296559
1,1,1,0,1,0,10,100,10
3120,3502,582,2920,3721,40,946.366667,95.13719098,1.626059565
13,7,6,1,7,0,3.066667,100,0.511111167
6635,5744,2015,3729,6891,248,5855.166667,86.4669577,2.905789909
16214,10663,6354,4309,11997,229,36789.8,90.61012916,5.790022033
2,2,2,0,2,0,0.533333,100,0.2666665
1502173,1436379,53434,1382945,1459869,14192,72222.35,99.35684112,1.351617884
8248218,7561336,907325,6654011,9204208,243406,1801582.4,84.38235774,1.985597663
1250,31310,3663,27647,36107,2870,295.666667,94.20224449,0.080717081
24121,7380,1198,6182,8158,363,1152.766667,94.67607441,0.962242627
583876,552734,151776,400958,626231,5662,609439.0833,89.06890289,4.015385063
20494,16320,7426,8894,20378,660,18501.15,82.76701491,2.491401831
23850,19250,9011,10239,23713,1663,29972.28333,87.3015873,3.326188362
57908097,55051983,18764231,36287752,62984342,940896,85985768.32,88.73134319,4.582429641
31764709,28491799,8830391,19661408,33165814,994214,46128937.23,88.56195837,5.223883884
10517,145346,38506,106840,162941,9106,1102.616667,94.48174993,0.028634931
1184037,1167801,363749,804052,1221644,6327,1102412.5,96.09023818,3.030695617
268,169,45,124,211,28,125.033333,92.34972678,2.778518511
2860,2117,1533,584,2320,47,6592.283333,93.13682358,4.300250054
13184,5845,3506,2339,6209,160,9157.45,96.62754174,2.61193668
127434,115829,60007,55822,122953,1546,284243.5,95.40553675,4.736839035
508,627,526,101,636,0,72.033333,98.58490566,0.1369455
6571,1706,1372,334,1745,35,915.7,99.76608187,0.667419825
41,37,18,19,37,0,190.733333,100,10.59629628
3063,1973,1259,714,2298,73,6466.866667,88.6741573,5.136510458
4448,1539,514,1025,1610,21,1441.083333,96.8533669,2.803664072
377311,326410,116303,210107,351756,6489,247810.5833,94.53842968,2.130732512
1408,1223,1144,79,1490,246,223.716667,98.31189711,0.195556527
7,3,1,2,12,3,0.116667,33.33333333,0.116667
3052,1913,1128,785,1954,19,610.8,98.8630491,0.541489362
224192,5,4,1,8,2,7.05,83.33333333,1.7625
8,8,5,3,8,0,6.6,100,1.32
6866089,1421866,689916,731950,3419222,1919628,197643.0833,94.8167304,0.286474126
2260506,1767573,973562,794011,2113774,244651,1424319.267,94.56697071,1.462998008
592282,147575,63011,84564,432567,275544,149968.7833,93.98304707,2.380041316
11422242,1291342,632852,658490,2913958,1527830,928830.25,93.16181478,1.467689523
1492192,1053683,695804,357879,1214057,101774,3559712.483,94.73155663,5.115970134
3357,14754,11641,3113,21985,6555,911.516667,95.61892417,0.078302265
12,3,3,0,6,3,5.016667,100,1.672222333
572,133,31,102,737,292,4.233333,29.88764045,0.136559129
88120,28076,15728,12348,35495,6965,29263.21667,98.4086926,1.860580917
1482,547,259,288,550,3,1297.133333,100,5.008236807
76311,32718,15717,17001,32812,77,56404.86667,99.94806782,3.588780726
178618,129797,48052,81745,131000,619,127211.8667,99.55208198,2.647379228
392,517,462,55,519,0,67.666667,99.61464355,0.146464647
483,181,105,76,220,38,151.6,99.45054945,1.443809524
472,245,105,140,252,2,132.683333,98,1.26365079
1386,559,267,292,601,28,590.5,97.55671902,2.211610487
26041,2318,1480,838,2567,38,1518.933333,91.65678134,1.026306306
141311,95580,42478,53102,102051,4528,39724.18333,98.00764948,0.935170755
509,49354,49332,22,49376,14,354.2,99.9837932,0.007179924
318503,234539,111860,122679,313763,79151,33611.83333,99.9688848,0.300481256
787,474,132,342,519,45,355.166667,100,2.690656568
6483,1863,1077,786,2148,283,3344.333333,99.89276139,3.105230578
21010,13603,9732,3871,16337,2730,34047.95,99.97060337,3.498556309
130759,96098,59100,36998,108673,12359,198987.5333,99.77573354,3.366963339
305,263,252,11,273,10,55.116667,100,0.218716933
14472,7088,2669,4419,8880,1788,2181.3,99.94359842,0.817272387
63,24,16,8,27,3,68.316667,100,4.269791688
2007,660,387,273,721,49,2057.016667,98.21428571,5.315288545
24952,5219,1553,3666,7726,1852,4802.166667,88.84916582,3.092187165
85957,35944,11076,24868,40150,3260,33273.03333,97.43561941,3.004065848
260,314,263,51,347,12,66.666667,93.73134328,0.253485426
1666,365,199,166,374,6,98.95,99.18478261,0.497236181
54,24,17,7,24,0,23.266667,100,1.368627471
5147,2484,1656,828,2604,59,6308.566667,97.60314342,3.809520934
145492,93730,49198,44532,127987,33607,206519.3,99.31129477,4.197717387
202400,154898,101015,53883,167439,5502,211690.7333,95.65324787,2.095636622
942,1251,1170,81,1338,84,183.65,99.76076555,0.156965812
8836,4642,3681,961,6715,2048,7535.283333,99.46432398,2.04707507
10,2,2,0,3,0,5,66.66666667,2.5
1667,1121,594,527,1192,24,2497.616667,95.9760274,4.204741864
207538,101193,46264,54929,116152,14265,126379.7667,99.31885324,2.7317086
701305,499044,246877,252167,547733,10312,1344769.617,92.85904347,5.447123939
783,3376,785,2591,3638,111,93.083333,95.71874114,0.118577494
48452,19455,15889,3566,20606,1109,5365.616667,99.78458224,0.337693792
5,5,4,1,5,0,2.183333,100,0.54583325
1140,1082,43,1039,1110,14,156,98.72262774,3.627906977
12868,11529,4974,6555,12760,235,16144.6,92.04790419,3.24579815
3,3,2,1,3,0,10.9,100,5.45
19731,6698,2719,3979,7918,24,15873.28333,84.8492526,5.837912223
321644,261405,81634,179771,287864,9166,184179.7833,93.79507567,2.256165119
793,1143,934,209,1212,10,52.816667,95.09151414,0.056548894
53479,6211,3431,2780,8069,1840,2394.733333,99.71102906,0.697969494
1065231,2,1,1,4,2,1.166667,100,1.166667
7,5,3,2,5,0,2.166667,100,0.722222333
27275,24528,23249,1279,25236,390,9461.383333,98.72011591,0.406958722
173710,135579,96846,38733,160178,15023,1139365.867,93.40291413,11.76471787
7,5,4,1,7,0,7.933333,71.42857143,1.98333325
6907424,3196142,505328,2690814,7501265,2978427,2080559.65,70.66673624,4.117245927
6620358,4292181,1198599,3093582,6880142,2077967,3214691.383,89.37993722,2.682040769
2174,91242,90117,1125,92034,577,749.666667,99.76491685,0.008318815
80,17,13,4,36,16,47.833333,85,3.679487154
84,32,7,25,86,27,9.366667,54.23728814,1.338095286
5760381,766725,250968,515757,854088,36147,146372.8,93.73842368,0.583232922
120,122,43,79,143,2,134.383333,86.5248227,3.125193791
1503,1316,482,834,1464,58,1838.783333,93.59886202,3.81490318
15819,17962,4198,13764,19039,105,17579.2,94.86637794,4.187517866
105653,99545,8317,91228,114726,2352,22385.66667,88.58365814,2.691555449
273,384,226,158,394,0,53.216667,97.46192893,0.235471978
28,23,10,13,23,0,124.85,100,12.485
5488,5661,1385,4276,6541,422,328.966667,92.51511685,0.237521059
321,271,29,242,351,0,56.516667,77.20797721,1.948850586
1042,595,416,179,733,11,904.166667,82.4099723,2.173477565
5843,1093,662,431,1094,0,2441.1,99.90859232,3.687462236
32692,26134,12879,13255,30087,238,34982.68333,87.55402191,2.716257732
14,56,47,9,56,0,0.25,100,0.005319149
1519,1147,382,765,1407,259,2219.5,99.91289199,5.810209424
12736,12377,12132,245,12419,6,2966.166667,99.70998147,0.244491153
19452,18424,14321,4103,18959,190,96193.73333,98.16186265,6.716970416
2657902,2267998,1442987,825011,2399530,12069,8098090.983,94.9962324,5.612033222
60742,55623,16054,39569,59406,267,58784.06667,94.05468473,3.661646111
2289414,1996150,1163331,832819,2167333,42561,5564961.533,93.9465505,4.783644151
4231,18840,4608,14232,21800,823,745.066667,89.81265195,0.161689815
6136,3476,1314,2162,4458,182,2733.633333,81.2909261,2.080390664
353,248,130,118,263,14,213.616667,99.59839357,1.643205131
5348,333,189,144,395,46,1519.666667,95.41547278,8.040564376
380748,329263,44891,284372,335947,6019,55819.08333,99.79844087,1.243435952
392698,393799,41718,352081,412965,7918,73309.61667,97.22303831,1.757265848
580,7191,6488,703,7298,96,92.066667,99.84726465,0.0141903
50885,20698,7389,13309,33672,8037,3369.066667,80.74117418,0.455957053
71,17,10,7,31,14,36.283333,100,3.6283333
457,72,39,33,74,2,109.683333,100,2.812393154
13099,458,78,380,522,59,132.483333,98.92008639,1.698504269
201386,162419,91751,70668,164747,1198,83568.35,99.30907557,0.910816776
335,550,296,254,611,49,49.45,97.86476868,0.167060811
5441,2537,1343,1194,3212,647,1077.233333,98.90838207,0.802109704
209,37,18,19,42,0,29.2,88.0952381,1.622222222
4709,1550,798,752,1837,67,3833.65,87.57062147,4.804072682
8,8,8,0,8,0,41.716667,100,5.214583375
94188,82415,21404,61011,83910,276,55609.8,98.54245881,2.598103158
411832,198264,63441,134823,199973,94,206018.2667,99.19201117,3.247399421
626,8155,7777,378,8167,1,2566.95,99.86529513,0.330069436
8359,5777,2571,3206,6522,572,3384.95,97.09243697,1.316588876
246,198,101,97,202,1,181.3,98.50746269,1.795049505
3715,2199,1137,1062,2296,32,6314.633333,97.12897527,5.553767223
256854,177586,59214,118372,181156,1588,99407.06667,98.89623986,1.678776415
251884,183690,42624,141066,194810,3490,117790.9333,96.01191721,2.763488488
448,1688,1173,515,1708,10,149.766667,99.41107185,0.127678318
26985,14288,6163,8125,16990,2590,6369.383333,99.22222222,1.033487479
108139,13,10,3,14,1,31.2,100,3.12
4695752,3127546,2116869,1010677,4267612,1057362,1144726.633,97.42375204,0.54076404
146,114,105,9,116,1,369.316667,99.13043478,3.51730159
1928908,1481407,1113427,367980,1868345,235106,3271314.183,90.70362635,2.938058969
89698270,47504361,29578964,17925397,71031212,14730109,86669724.77,84.37554234,2.930113603
1,1,1,0,1,0,2.366667,100,2.366667
60772962,34983613,23012755,11970858,50602032,9583888,90341214.65,85.28814224,3.92570184
47040,138114,125600,12514,150134,9611,11911.3,98.28568989,0.094835191
36,2,2,0,2,0,0.483333,100,0.2416665
36100,35188,4241,30947,36829,94,84326.2,95.78875732,19.8835652
452343,133521,15075,118446,402213,50460,22061.18333,37.95873809,1.463428413
142,124,79,45,127,3,75.133333,100,0.951054848
785,152,95,57,173,21,1044.516667,100,10.99491228
6731,3522,1887,1635,3756,193,2482.5,98.84928431,1.315580286
16850,5805,2464,3341,6378,541,7582.866667,99.45177317,3.077462121
255,257,235,22,258,1,62.133333,100,0.264397162
1672,615,328,287,823,207,428.833333,99.83766234,1.307418698
630,583,141,442,819,3,229.516667,71.44607843,1.62777778
1917,1530,1180,350,1688,9,4224.116667,91.12567004,3.579759887
16711,4140,2157,1983,4216,57,7859.583333,99.54315941,3.643756761
89422,87966,37240,50726,106255,201,76545.61667,82.94453769,2.055467687
56,61,57,4,63,2,0.933333,100,0.016374263
2591,1175,681,494,2477,425,563.883333,57.26120858,0.828022515
173,48,28,20,69,20,40.7,97.95918367,1.453571429
146,76,57,19,81,3,458.15,97.43589744,8.037719298
5475,234,169,65,235,0,199.55,99.57446809,1.180769231
102320,5379,2545,2834,6503,720,4500.983333,93.01400657,1.768559266
30,39,25,14,42,3,4.15,100,0.166
1849,1211,808,403,1439,227,396.716667,99.91749175,0.490985974
121,88,36,52,88,0,44.733333,100,1.242592583
1075,683,492,191,836,0,2165.4,81.69856459,4.401219512
92164,47482,21076,26406,63466,66,17760.53333,74.89274448,0.842689947
565223,472618,109444,363174,527701,2221,131568.95,89.94024511,1.202157724
15,14170,13616,554,14175,4,20.233333,99.99294333,0.001485997
5179,1480,757,723,2988,1508,893.483333,100,1.180295024
24,22,10,12,22,0,7.15,100,0.715
18858,17546,17343,203,17577,9,5118.233333,99.87477231,0.295118107
70020,46232,32896,13336,48866,2098,421679.9167,98.85391721,12.81857723
2,2,2,0,2,0,0.8,100,0.4
53296,35420,15702,19718,39176,2137,95550.98333,95.62893167,6.0852747
3760101,3441376,2067938,1373438,3508751,49165,2581843.167,99.47363644,1.248510916
2245,4523,4127,396,4567,26,479.15,99.60361154,0.116101284
274292,238295,93025,145270,249934,5175,228841.5667,97.35903481,2.460000717
1418148,695894,170156,525738,832295,14915,491778.1,85.13714551,2.890160206
25,17,11,6,18,1,12.366667,100,1.124242455
138377,27011,21648,5363,74509,824,13527.7,36.65739296,0.624893755
812417,456311,278644,177667,1075140,116145,4338287.117,47.58220846,15.56928237
28,19,15,4,30,7,253.216667,82.60869565,16.88111113
7159165,1931633,635586,1296047,2894844,164933,2749427.9,70.75809431,4.325815704
85870510,40309708,12269492,28040216,55451078,3702780,53055253.22,77.89571746,4.324160545
73651,117044,25739,91305,161283,17979,1153.65,81.6753196,0.044821089
102,87,72,15,89,0,237.833333,97.75280899,3.303240736
176,113,6,107,235,65,26.066667,66.47058824,4.3444445
1182382,30304,3854,26450,33935,875,16368.51667,91.66364186,4.247150147
17,11,7,4,11,0,4.433333,100,0.633333286
25461,25088,23343,1745,25223,125,4561.4,99.96015619,0.195407617
104597,95518,79171,16347,98804,3101,510349.4667,99.80669363,6.446166736
6,5,5,0,6,1,1.45,100,0.29
1147245,1089482,684723,404759,1115794,24985,3261867.917,99.87834717,4.763777347
2146777,1914656,1278572,636084,2058376,140817,2007395.433,99.84860961,1.570029246
3972,6156,5418,738,6212,29,399.733333,99.56331878,0.073778762
2236,1163,343,820,1294,107,976.2,97.97809604,2.84606414
37,7,7,0,10,3,4.5,100,0.642857143
395,60,28,32,102,31,253.7,84.50704225,9.060714286
7292,601,369,232,602,0,307.85,99.83388704,0.834281843
13980,8697,4514,4183,9613,468,2811.7,95.10114817,0.62288436
10,154,123,31,154,0,0.75,100,0.006097561
14610,11179,8316,2863,13357,2169,3261.483333,99.91955667,0.392193763
218,130,61,69,138,2,91.166667,95.58823529,1.494535525
1357,427,210,217,499,43,780.283333,93.64035088,3.715634919
235132,81228,57587,23641,90387,28,118116.15,89.89475315,2.051090524
235101,198751,56993,141758,205427,2378,45164.53333,97.88326956,0.792457553
414,802,567,235,1026,217,24.533333,99.13473424,0.043268665
35563,22585,6475,16110,29835,5850,3050.433333,94.16301855,0.471109395
1,1,1,0,1,0,0.8,100,0.8
26,13,8,5,14,0,101.883333,92.85714286,12.73541663
27789,51014,9231,41783,51909,0,3217.866667,98.27582885,0.348593507
36008,38008,5749,32259,38849,0,2019.016667,97.83520811,0.351194411
1,109,66,43,110,0,0.25,99.09090909,0.003787879
59,17,16,1,19,2,10.3,100,0.64375
125,71,66,5,75,4,124.266667,100,1.882828288
31473,26750,23756,2994,28638,1082,593807.5333,97.07504718,24.99610765
107845,32823,21703,11120,34952,938,59520.41667,96.49850062,2.742497197
308347,234119,139425,94694,263659,14653,334857.2667,94.0214292,2.401701751
1078,1436,1417,19,1445,9,410.516667,100,0.289708304
3027,1995,833,1162,2161,164,1243.966667,99.89984977,1.493357343
32123,11,5,6,11,0,1.15,100,0.23
866,794,416,378,845,13,469.783333,95.43269231,1.129286858
4275,2780,1595,1185,3040,82,10454.6,93.98242055,6.55460815
48361,26494,14312,12182,33368,1596,21778.68333,83.38788871,1.521707891
566261,426770,171767,255003,533005,65691,215866.0667,91.3240348,1.256737713
815,1562,1342,220,1636,18,83.766667,96.53893696,0.062419275
176122,121119,35817,85302,132455,5051,30588.43333,95.06687388,0.854019972
10,10,7,3,10,0,5.016667,100,0.716666714
15126,14951,13848,1103,15008,12,2619.933333,99.69991998,0.189192182
22269,16458,13354,3104,20093,979,21375.26667,86.10442608,1.600663971
1673088,1061230,521099,540131,1090823,24131,3081944.1,99.48794966,5.914315898
101037,73022,32930,40092,79248,3689,271828.2333,96.64235895,8.254729224
157225,93239,30745,62494,117097,9542,99834.21667,86.68960067,3.247169187
1661,5215,1216,3999,5684,178,172.166667,94.71485652,0.14158443
234,58,1,57,559,2,0.05,10.41292639,0.05
30327,23555,12036,11519,24838,226,161266.3167,95.70534699,13.39866373
6760,57,55,2,58,0,152.45,98.27586207,2.771818182
313,313,313,0,313,0,280.366667,100,0.89574015
135,18,18,0,18,0,25.733333,100,1.429629611
1225,814,417,397,822,3,2132.1,99.38949939,5.11294964
273,271,271,0,273,0,1020.783333,99.26739927,3.766728166
145923,52579,13600,38979,52976,252,45097.61667,99.72498293,3.316001226
2072324,1376729,525558,851171,1523738,17048,2222719.133,91.37440349,4.229255636
966,906,692,214,1362,15,62.116667,67.26057906,0.08976397
4499,1962,1709,253,1974,9,3522.3,99.84732824,2.061029842
9392,9300,9154,146,9356,3,2055.383333,99.4333369,0.224533901
6138,5245,3951,1294,5441,51,23520.83333,97.30983302,5.953134228
89005,77509,42098,35411,79313,293,147303.8167,98.08782587,3.499069235
40111,37245,10876,26369,39738,807,37497.71667,95.669261,3.447748866
414348,373418,126277,247141,392343,3804,327026.9333,96.10824139,2.589758494
991,1386,1048,338,1516,13,149.3,92.21556886,0.142461832
1809,842,515,327,1002,49,1796.333333,88.35257083,3.488025889
773,3,2,1,3,0,5.7,100,2.85
66839,66167,65838,329,66231,45,14753.33333,99.97129302,0.224085381
346429,354331,328604,25727,356140,1324,793395.65,99.86330943,2.414443068
51842,36480,13668,22812,41424,3147,42099.85,95.30527471,3.080176324
123711,98964,51439,47525,116502,8368,407926.1333,91.51978101,7.930288951
297167,257756,108241,149515,281633,21920,334251.0667,99.24647592,3.08802641
1639,3088,1608,1480,3577,236,355.833333,92.42741694,0.221289386
18,14,6,8,14,0,26.383333,100,4.397222167
142241,123086,56345,66741,136100,6117,291414.45,94.69392151,5.171966457
395,326,143,183,339,1,335.166667,96.44970414,2.343822846
2095,872,381,491,1017,26,2672.8,87.99192735,7.015223097
218422,62174,25399,36775,69407,859,29246.43333,90.70140631,1.151479717
845627,517481,159120,358361,639905,2305,240057.3833,81.1607591,1.508656255
506,2664,1710,954,2759,7,101.95,96.80232558,0.059619883
603598,548699,293510,255189,654980,40041,125051.0833,89.22819987,0.426053911
72879,71119,70555,564,71265,115,22086.8,99.95643008,0.313043725
385892,363491,353381,10110,365970,1625,615747.7833,99.76560677,1.74244734
2943731,1774792,842038,932754,1950171,143308,1240106.367,98.22504529,1.472743946
4313694,3273185,1688900,1584285,4027346,351964,3732823.333,89.05700142,2.210209801
3418,10526,3934,6592,16428,4969,297.166667,91.85792827,0.075538044
1578,1030,846,184,1652,315,381.65,77.0381451,0.451122931
379960,36089,20760,15329,42478,5315,21218.76667,97.11002879,1.022098587
96,6,1,5,6,0,0.1,100,0.1
5588,52,28,24,83,14,20.116667,75.36231884,0.718452393
8,7,3,4,8,1,3.95,100,1.316666667
46,14,2,12,14,0,3.266667,100,1.6333335
1025,188,66,122,195,7,294.116667,100,4.456313136
26017,1207,700,507,1254,40,1287.716667,99.42339374,1.839595239
270337,222265,45242,177023,229082,867,138597.0667,97.39280941,3.063460207
51,396,175,221,407,0,6.816667,97.2972973,0.038952383
1541,336,247,89,557,221,152.633333,100,0.617948717
116,47,11,36,66,6,23.483333,78.33333333,2.134848455
915,363,164,199,421,12,413.766667,88.75305623,2.522967482
50731,19450,6750,12700,19522,1,16871.51667,99.63628912,2.499483951
201750,104060,65156,38904,122900,13422,90553.18333,95.05106049,1.3897904
18,3862,510,3352,3867,0,6.033333,99.8707008,0.011830065
28331,2,2,0,2,0,14.916667,100,7.4583335
13839,13363,12489,874,13696,308,2813.016667,99.81326561,0.225239544
91,75,1,74,77,1,4.4,98.68421053,4.4
28914,18890,16589,2301,19709,707,10765.35,99.41058836,0.648945084
13341840,12469650,7575253,4894397,12586361,37805,52633731.62,99.37119458,6.948115346
1934923,1552153,747174,804979,1583596,26132,1838140.283,99.65899693,2.460123456
746,11978,11176,802,12028,5,376,99.62571738,0.033643522
3255,1909,989,920,2063,19,1529.316667,93.39530333,1.546326256
1375,4,2,2,5,0,17.25,80,8.625
126,12,7,5,12,0,41.866667,100,5.980952429
167,25,4,21,63,17,58.566667,54.34782609,14.64166675
4837,3485,2089,1396,5473,132,1068.116667,65.24995319,0.51130525
4,1,1,0,1,0,0,100,0
258,225,188,37,231,5,861.7,99.55752212,4.583510638
92505,71871,64868,7003,72281,252,106585.1167,99.78064391,1.643107798
409822,157684,50347,107337,160481,1914,119717.2833,99.4431376,2.377843433
853898,664609,251732,412877,681796,10597,556384.3,99.01817494,2.210224763
997,2736,2405,331,2801,34,161.883333,98.87965305,0.067311157
53274,40062,21530,18532,44222,3786,28051.66667,99.07508161,1.302910667
6094,2,2,0,2,0,6.966667,100,3.4833335
64,58,30,28,58,0,25.15,100,0.838333333
3072,1989,659,1330,2185,24,1785.983333,92.04072189,2.710141628
3,1,1,0,2,0,1.166667,50,1.166667
97759,57755,36369,21386,65456,599,204266.25,89.04975562,5.616493442
37,21,16,5,42,5,87.566667,56.75675676,5.472916688
845293,645427,215113,430314,737366,3864,1082025.1,87.99253444,5.030031193
4095710,3814900,523064,3291836,5733509,19653,1644060.6,66.76577079,3.143134683
3337,23345,5759,17586,24968,357,457.883333,94.85595872,0.079507438
5,1,1,0,1,0,0.933333,100,0.933333
1236,777,134,643,1722,89,144.166667,47.58113901,1.075870649
207581,77553,50381,27172,97023,19212,42077.88333,99.66842734,0.835193492
21,14,7,7,16,2,15.116667,100,2.159523857
61,27,15,12,29,2,27.45,100,1.83
5523,2672,2161,511,2969,267,7513.7,98.88971132,3.476955113
4,2,2,0,4,2,41.233333,100,20.6166665
185121,152590,95031,57559,157544,2778,359497.8833,98.59400644,3.782953808
492753,409395,237627,171768,433405,14573,1289420.683,97.74682928,5.42623811
290,967,931,36,989,12,74.083333,98.97645855,0.079573934
8014,4579,3372,1207,4664,44,3779.066667,99.11255411,1.120719652
5572,92,57,35,101,8,16.433333,98.92473118,0.288304088
3,3,2,1,5,0,2.133333,60,1.0666665
170,80,39,41,81,0,76.666667,98.7654321,1.965811974
2324,288,179,109,295,0,1175.25,97.62711864,6.565642458
5,3,3,0,4,1,2.583333,100,0.861111
2432,232,119,113,241,1,725.483333,96.66666667,6.096498597
65182,47044,30885,16159,48337,523,62836.11667,98.38959301,2.034518914
75,623,533,90,629,0,1.3,99.04610493,0.002439024
11462,293,176,117,293,0,125.516667,100,0.713162881
12,8,6,2,9,1,11.65,100,1.941666667
796,45,20,25,70,2,63.833333,66.17647059,3.19166665
26198697,17985033,6180232,11804801,22701053,1777306,10326435.88,85.95512553,1.670881592
5551949,4854055,873113,3980942,5827591,215103,3333705.617,86.48668826,3.818183462
640,85726,67529,18197,89054,1849,484.4,98.30399633,0.007173214
546489,376822,157398,219424,533899,42330,76872.25,76.65699017,0.488394071
15160,15059,15011,48,15330,0,2899.183333,98.2322244,0.193137255
13866,12684,11554,1130,12999,138,16684.3,98.62374621,1.444028042
38797,32947,11007,21940,38281,3966,25099.86667,96.01340522,2.280354926
717967,543448,57359,486089,769783,168125,183232.85,90.32506839,3.19449171
1299,1992,1085,907,2132,79,157.216667,97.02873843,0.144900154
5577,4180,1913,2267,5299,671,3259.983333,90.31979257,1.704120927
159,114,43,71,116,1,111.05,99.13043478,2.58255814
4203,3409,1532,1877,3428,3,6202.4,99.53284672,4.048563969
1092645,986557,346035,640522,1064507,2695,1655939.283,92.91258716,4.785467607
799625,685343,257801,427542,713941,3028,852490.15,96.40321671,3.306775963
704,4709,1515,3194,4904,4,76.866667,96.10204082,0.050737074
126508,51491,13697,37794,102429,50128,63400.86667,98.45127244,4.628814096
8221,2,1,1,2,0,0.283333,100,0.283333
2317,598,137,461,674,56,57.05,96.76375405,0.416423358
625,135,104,31,168,32,145.066667,99.26470588,1.394871798
240,148,40,108,180,23,99.95,94.26751592,2.49875
548,334,100,234,355,11,491.1,97.09302326,4.911
14064,6190,1978,4212,6942,656,11259.45,98.47279669,5.692340748
248,251,249,2,252,1,65.866667,100,0.264524767
352,136,63,73,156,20,12.216667,100,0.193915349
50,47,36,11,47,0,89.4,100,2.483333333
1182,807,565,242,842,34,2037.633333,99.87623762,3.606430678
199740,179781,24591,155190,179990,34,121273.9167,99.90275401,4.931638269
67464,59694,25530,34164,60709,48,101048.4333,98.40589506,3.958027158
8,609,465,144,611,0,18.233333,99.67266776,0.039211469
5871,1932,1610,322,2497,562,877.85,99.84496124,0.545248447
70741,79869,69395,10474,81106,258,14979.81667,98.78908569,0.215863054
350485,420273,330684,89589,433826,2956,472001.95,97.54055748,1.427350431
504718,609080,209473,399607,636732,24216,466084.1167,99.43903506,2.225031945
30272,19195,10228,8967,21925,1194,64206.03333,92.59080604,6.277476861
530551,489562,143653,345909,606682,73422,263039.3667,91.80549826,1.83107465
1186,2049,1267,782,2509,406,172.45,97.43223966,0.136108919
23950,17750,14880,2870,23150,5286,9985.4,99.36184505,0.671061828
262497,529,339,190,1637,45,1286.283333,33.22864322,3.794346115
21,9,5,4,13,2,5.016667,81.81818182,1.0033334
2048494,1826151,1322362,503789,2065601,167388,397197.7833,96.20369263,0.300369931
21257363,18344600,12005636,6338964,20796544,2120726,8593305.317,98.22648732,0.715772602
19,3,2,1,4,0,94.516667,75,47.2583335
8242795,6747215,5333793,1413422,7818221,785423,6099471.183,95.93926912,1.143552287
2324862,1884980,611465,1273515,2284967,141260,1056785.8,87.93085995,1.72828502
167704022,132938813,75164997,57773816,164007919,26253404,40129485.37,96.50414217,0.533885279
38433,1185996,151168,1034828,1817010,598262,11573.11667,97.312652,0.07655798
175,63,47,16,63,0,48.283333,100,1.027304957
139,51,25,26,139,44,806.366667,53.68421053,32.25466668
5950,3254,2051,1203,4023,108,1731.083333,83.11621967,0.844019177
185,77,47,30,82,5,18.333333,100,0.390070915
835,250,206,44,267,17,541.766667,100,2.629935277
12468,7938,5287,2651,10047,1246,12397.21667,90.1942961,2.344849001
143053,54144,45149,8995,85086,26144,24917.56667,91.85979437,0.551896314
119900,76996,506,76490,119651,207,123.35,64.4620073,0.243774704
4222,2441,1402,1039,3800,1329,413,98.78591663,0.294579173
33,9,8,1,41,0,14.816667,21.95121951,1.852083375
760,303,201,102,315,3,1042.166667,97.11538462,5.184908791
1716,1361,864,497,1475,10,3807.5,92.90102389,4.406828704
19758,14098,8209,5889,18063,21,19078.26667,78.1398958,2.324067081
7,53,20,33,58,1,0.383333,92.98245614,0.01916665
10113,6450,5684,766,6611,152,1218.066667,99.86065954,0.214297443
177,151,79,72,170,3,171.733333,90.41916168,2.173839658
2215,1563,870,693,1698,36,8885.066667,94.0433213,10.21272031
13045,4718,162,4556,6403,919,1049.066667,86.03209336,6.475720167
1126025,771735,40788,730947,785583,1987,51670.53333,98.48633735,1.266807231
492,3697,3461,236,3728,5,65.516667,99.30163846,0.018929982
59936,42003,9235,32768,60591,17384,6766.016667,97.21341449,0.732649341
312,175,105,70,185,1,291.383333,95.10869565,2.775079362
204864,165855,47897,117958,212904,535,126205.35,78.09755661,2.63493225
148855,128333,36116,92217,140272,1047,80882.58333,92.1766924,2.239522188
279,231,231,0,232,0,62,99.56896552,0.268398268
1347,993,193,800,1062,60,139.633333,99.10179641,0.723488772
97,61,13,48,64,3,31.5,100,2.423076923
5990,4083,2715,1368,4371,132,10160.11667,96.31988677,3.742216084
20591,12811,6160,6651,14546,1038,14214.71667,94.84009476,2.307583875
737856,611398,70018,541380,639306,6697,169892.8667,96.64706003,2.426417017
690,2232,1717,515,2260,14,75.75,99.37666963,0.044117647
1739,596,401,195,672,70,397.25,99.00332226,0.990648379
37958,21,12,9,22,1,174.516667,100,14.54305558
206389,201881,196749,5132,204934,1893,83767.63333,99.42868682,0.425758877
1213094,1068550,876476,192074,1229355,66983,6972048.183,91.92840158,7.954636731
103,56,43,13,69,10,653.55,94.91525424,15.19883721
50810407,37445497,18268377,19177120,42616592,4184676,48662674.17,97.43333379,2.663765597
25971844,21533305,14304546,7228759,25146455,3047964,36688876.25,97.44242265,2.564840314
43109,74434,46310,28124,88968,10115,9028.35,94.39590123,0.194954653
521,178,81,97,315,136,659.133333,99.44134078,8.137448556
8867,3701,979,2722,10834,3209,301.516667,48.53770492,0.307984338
2150022,1145091,654720,490371,1290859,141538,178636.0833,99.63195661,0.27284348
662,483,189,294,497,6,526.15,98.3706721,2.783862434
10945,7932,4146,3786,9694,1334,16194.95,94.88038278,3.906162566
278063,145844,40103,105741,178347,20711,54350.91667,92.51947525,1.355283063
1288368,902816,344281,558535,944547,19610,519194.0167,97.60837765,1.508053063
4125,5238,1931,3307,5507,189,130.666667,98.49567507,0.067667875
7639,7639,7639,0,7639,0,2755.366667,100,0.360697299
98641,61750,37151,24599,71340,8833,14016.83333,98.78893564,0.377293568
52,24,21,3,25,1,44.866667,100,2.136507952
1589,763,504,259,861,90,2703.566667,98.96238651,5.364219577
1207,622,399,223,741,105,2785,97.79874214,6.979949875
43305,31023,16457,14566,32988,1861,53652.48333,99.66588492,3.260161836
5,21,15,6,24,3,0.566667,100,0.0377778
469,82,70,12,240,158,44.566667,100,0.636666671
39,39,22,17,39,0,22.85,100,1.038636364
21684,21206,21013,193,21278,25,4379.516667,99.77885475,0.208419391
85822,72117,54652,17465,73804,582,374035.25,98.49089072,6.843944412
10,10,9,1,11,0,15.916667,90.90909091,1.768518556
2859124,1403400,516500,886900,1571886,93278,1601722.517,94.91359441,3.101108454
226129,215658,46384,169274,230533,7257,241565.6667,96.58807933,5.207952455
2373570,2267046,1204660,1062386,2316830,27359,5726180.4,99.02051609,4.753358126
1578,29937,5825,24112,38863,3769,714,85.30518037,0.122575107
14318,2276,1069,1207,3050,346,4734.6,84.17159763,4.428999065
834,4,3,1,4,0,6.066667,100,2.022222333
140,35,21,14,59,18,239.3,85.36585366,11.3952381
149,89,23,66,118,14,223.433333,85.57692308,9.714492739
4142,2203,647,1556,3522,305,1564.916667,68.47995026,2.418727461
254,252,247,5,252,0,65.95,100,0.267004049
90,51,44,7,53,2,2.15,100,0.048863636
83,52,9,43,66,0,8.383333,78.78787879,0.931481444
860,358,215,143,484,22,680.383333,77.48917749,3.164573642
10304,6096,3860,2236,7474,55,21851.13333,82.16740801,5.660915371
86966,70320,34443,35877,78860,2461,159446.1167,92.04308957,4.629274937
247,951,609,342,1009,2,118.983333,94.43892751,0.195374931
877,102,7,95,106,0,5.783333,96.22641509,0.826190429
240,223,137,86,236,5,44.316667,96.53679654,0.323479321
2259,1310,1106,204,1339,14,3827.716667,98.86792453,3.460864979
220695,17306,9797,7509,44550,23842,20136.31667,83.57156654,2.055355381
274895,207360,153433,53927,249401,36394,77090.6,97.34891342,0.502438198
15,268,206,62,687,335,0.183333,76.13636364,0.000889966
58728,25843,17693,8150,43743,17814,3761.416667,99.66832504,0.212593493
382,190,108,82,344,154,173.5,100,1.606481481
12245,10933,5542,5391,11239,232,5947.016667,99.32770055,1.073081318
91155,80239,30006,50233,92575,11990,129605.8333,99.5706397,4.319330578
266,118,65,53,122,4,3.25,100,0.05
1283,583,215,368,848,262,179.666667,99.48805461,0.835658916
122,86,43,43,87,0,194.633333,98.85057471,4.526356581
8973,4479,2695,1784,4682,135,14184.33333,98.50450847,5.263203463
315382,186200,110795,75405,197772,9837,349851.5667,99.07680847,3.157647607
548092,483562,307614,175948,501502,8743,929869.1167,98.13357037,3.022843943
505,2237,2035,202,2243,5,490.483333,99.95531725,0.241023751
69327,46417,33702,12715,55493,8477,49207.4,98.72596563,1.460073586
47267,4,1,3,4,0,1.516667,100,1.516667
10,9,7,2,9,0,4.433333,100,0.633333286
290,193,111,82,202,2,115.95,96.5,1.044594595
484,306,199,107,328,1,924.5,93.57798165,4.645728643
8,5,5,0,7,2,69.266667,100,13.8533334
51849,17588,8381,9207,20077,1,4090.8,87.60709305,0.488104045
943216,817406,218947,598459,867298,11326,333153.2833,95.49447879,1.521616114
147,429,370,59,440,0,10.616667,97.5,0.028693695
15735,6025,4341,1684,6578,540,3018.05,99.78469692,0.695243032
47,19,8,11,19,0,8.05,100,1.00625
205,2,1,1,16,0,1.366667,12.5,1.366667
4042,533,202,331,549,3,345.266667,97.61904762,1.709240926
91810,83504,33269,50235,94949,542,80899.61667,88.45106825,2.431681646
8,40,26,14,44,1,1.883333,93.02325581,0.072435885
3872,821,580,241,954,133,343.833333,100,0.592816091
15,7,2,5,7,0,4.983333,100,2.4916665
574,229,153,76,274,28,629.65,93.08943089,4.115359477
9623,8401,5269,3132,9393,423,29753.3,93.65663322,5.646858987
66136,42382,22009,20373,52139,3832,91929.7,87.73469683,4.17691399
170,318,303,15,371,1,17.2,85.94594595,0.056765677
5072,585,440,145,609,13,678.566667,98.15436242,1.54219697
3,3,3,0,3,0,1.416667,100,0.472222333
70,23,19,4,23,0,52.65,100,2.771052632
2453,861,593,268,906,16,1734.483333,96.74157303,2.924929735
66377,40553,15199,25354,47832,63,39516.43333,84.89396889,2.599936399
500477,383828,265550,118278,389136,1300,482537.8833,98.9665735,1.817126279
586,1154,1146,8,1191,0,78.166667,96.89336692,0.068208261
3112,1884,1587,297,2125,235,1097.483333,99.68253968,0.691545894
2220,6,6,0,8,0,19.216667,75,3.202777833
86,22,16,6,22,0,23.933333,100,1.495833313
5158,1877,1212,665,2151,58,7550.95,89.67988533,6.230156766
355181,327506,183425,144081,333069,5213,301969.2167,99.89324582,1.646281677
602647,562596,257727,304869,585284,10912,667984.95,97.94976078,2.591831473
1243,10995,10781,214,11087,33,3647.283333,99.46625656,0.338306589
34655,29328,21505,7823,29714,276,20541.43333,99.62633331,0.955193366
103771,4,3,1,3971,3967,0.95,100,0.316666667
156346,129213,80816,48397,149749,3916,27880.28333,88.60340252,0.344984698
473747,468173,406877,61296,497045,4105,969360.15,94.97565627,2.382440271
2217050,2139450,385050,1754400,2612672,70885,983769.0333,84.17109695,2.554912436
6881430,3345253,1880496,1464757,4011912,138419,8684533.433,86.36269641,4.618214255
4653,8682,4254,4428,8992,70,1832.1,97.31002017,0.43067701
249,249,249,0,249,0,149.633333,100,0.60093708
21326,20657,19874,783,22690,262,151006.7833,92.10362047,7.598207876
131903,114874,80577,34297,119175,3367,115053.6667,99.19349268,1.427872304
680,2,1,1,2,0,3.45,100,3.45
12,12,5,7,12,0,2.266667,100,0.4533334
69960,69290,68799,491,69396,101,14229.26667,99.99278447,0.206823743
369693,360816,349185,11631,365633,3921,731787.7833,99.75228911,2.09570223
354417,268006,135367,132639,275942,6761,549517.7833,99.56349074,4.059466364
46130,32588,18760,13828,33815,846,156854.7167,98.84436895,8.361125622
260468,192721,92701,100020,232257,37473,417738.5833,98.9408781,4.506300723
1286,2351,1803,548,2682,321,285.45,99.57645066,0.158319468
184,4,2,2,363,0,1.55,1.101928375,0.775
61620,59350,27255,32095,59922,463,92633.91667,99.8166804,3.398786155
610,570,423,147,602,15,903.483333,97.10391823,2.135894404
2784,2090,1217,873,2347,207,8204.733333,97.6635514,6.741769378
115590,87790,7280,80510,102677,3577,15489.53333,88.58728557,2.12768315
227734,183259,66904,116355,218165,18665,243742.2,91.85914787,3.643163339
976,1017,821,196,1263,79,114.683333,85.89527027,0.139687373
1871,1273,650,623,1661,376,4641.783333,99.06614786,7.141205128
446425,45308,8617,36691,66459,5506,48205.58333,74.33268256,5.594242002
103,61,31,30,62,0,48.883333,98.38709677,1.57688171
838244,766729,51462,715267,956228,3214,120864.4333,80.45306785,2.348615159
5156862,4791442,3148162,1643280,5370348,40773,47227806.02,89.90289094,15.00170767
24,23,18,5,24,0,56.816667,95.83333333,3.1564815
70181505,64500009,29237672,35262337,72275176,487265,186773324.2,89.84800937,6.38810519
230388185,216377401,98171289,118206112,234782815,2860614,553684051.3,93.29740752,5.639979437
550300595,308392023,99730049,208661974,564525929,10669128,309445304,55.68082263,3.102829158
141,6,4,2,11,4,4.35,85.71428571,1.0875
3094355,2878540,2835587,42953,3178044,11609,48604789.03,90.90791379,17.14099727
17800,13851,13667,184,13994,2,22067.66667,98.9922813,1.614667935
8548122,6630182,1839544,4790638,6931734,107454,9114339.133,97.15577321,4.954673078
21980,97,94,3,97,0,24.45,100,0.260106383
502,502,501,1,502,0,161.283333,100,0.32192282
2563,2151,1279,872,2606,170,4328.416667,88.30049261,3.384219443
75448,62144,33129,29015,81387,4612,133405.2667,80.9430153,4.026842545
239,236,236,0,239,0,245.1,98.74476987,1.038559322
5,5,5,0,5,0,273.683333,100,54.7366666
3874665,3169524,968709,2200815,4101459,399343,2769977.167,85.61384894,2.859452288
7011508,5319167,1197968,4121199,6599114,461716,3651145.85,86.66811245,3.047782453
3951,10595,5597,4998,11743,122,685.833333,91.17115567,0.122535882
4419,2309,176,2133,4425,581,366.533333,60.06763788,2.082575756
333876,210393,59870,150523,272489,52031,30542.98333,95.43450453,0.510155058
425,394,315,79,403,3,565.85,98.5,1.796349206
836,788,400,388,790,0,681.216667,99.74683544,1.703041668
28025,23941,13297,10644,24141,7,24624.56667,99.20029833,1.851888897
12,60,55,5,64,0,18.683333,93.75,0.339696964
1834,1682,793,889,1707,21,1685.116667,99.76275208,2.124989492
3,2,1,1,3,1,0.15,100,0.15
188,163,22,141,164,0,27.116667,99.3902439,1.232575773
3,4,4,0,4,0,0.533333,100,0.13333325
0,20,19,1,22,1,0.05,95.23809524,0.002631579
0,22,22,0,22,0,0,100,0
55,31,6,25,57,10,16.55,65.95744681,2.758333333
1206,551,108,443,989,232,270.983333,72.78731836,2.509104935
0,1,1,0,1,0,0,100,0
115,73,72,1,73,0,85.216667,100,1.183564819
47,42,25,17,50,0,16.383333,84,0.65533332
51,16,5,11,27,0,0.45,59.25925926,0.09
3166,2783,302,2481,2857,38,132.983333,98.7229514,0.440342162
2,1,1,0,1,0,0.216667,100,0.216667
77,45,20,25,55,10,46.966667,100,2.34833335
2,2,2,0,2,0,0,100,0
2108,2093,474,1619,2098,5,692.9,100,1.461814346
753323,711839,307571,404268,711920,24,524843.2167,99.99199321,1.706413208
14,339,338,1,339,0,0.216667,100,0.000641027
10,7,5,2,7,0,3.533333,100,0.7066666
705,58,25,33,87,29,63.3,100,2.532
25950,4134,2128,2006,5803,1604,13809.35,98.45201238,6.489356203
13,11,11,0,11,0,49.7,100,4.518181818
82683,40355,16512,23843,53580,7551,62963.66667,87.67298877,3.813206557
1158753,835972,338430,497542,893535,43932,641155.25,98.39560359,1.894498862
577,2172,1862,310,2228,39,146.266667,99.22338968,0.078553527
6929,545,129,416,614,54,225.083333,97.32142857,1.744832039
77,54,25,29,54,0,59.266667,100,2.37066668
17761,14328,9183,5145,14515,38,15713,98.97078124,1.711096592
222020,148019,41960,106059,150242,1060,37830.68333,99.22041533,0.901589212
2250380,1681354,494301,1187053,1754097,47739,389934.7833,98.53465685,0.788861004
869,5615,4610,1005,5669,18,206.55,99.36294461,0.044804772
41950,29792,17098,12694,34290,2869,10591.9,94.81556921,0.619481811
382724,250684,121021,129663,358165,99085,51860.65,96.75930215,0.428526041
725716,687050,626078,60972,713064,16102,2112821.767,98.57782777,3.374694154
1297638,1098302,359131,739171,1246828,125472,730294.4333,97.94409625,2.033504302
4076559,3075578,1581319,1494259,3590123,459913,4162886.45,98.25468579,2.632540588
5039,16299,5671,10628,18562,1575,607.85,95.949844,0.107185682
34,4,1,3,4,0,1.616667,100,1.616667
157489,125179,72638,52541,127405,1735,42273.16667,99.60929418,0.58197041
190,3,1,2,3,0,1.083333,100,1.083333
64,3,1,2,4,1,1.083333,100,1.083333
192,200,59,141,200,0,45.483333,100,0.770903949
5681,4624,1598,3026,4641,0,1687.583333,99.63369963,1.056059658
3,12,9,3,13,1,1.683333,100,0.187037
12,7,3,4,8,1,1.433333,100,0.477777667
18695,18391,18221,170,18427,32,4709.35,99.97825496,0.258457275
79045,68752,58666,10086,73924,4943,665923.9,99.66802453,11.35110456
7,6,6,0,6,0,37.4,100,6.233333333
389773,300192,155558,144634,363028,48071,1030639.55,95.31205847,6.62543585
2949314,2655930,1431315,1224615,2919087,229677,7555645.383,98.75511729,5.278813806
841,7525,5234,2291,9914,2271,116.216667,98.45610362,0.022204178
88,28,23,5,117,1,3.733333,24.13793103,0.162318826
3962,2264,1126,1138,2858,580,2064.916667,99.38542581,1.833851392
78968,78585,73951,4634,80703,566,20030.28333,98.06331657,0.270858857
627209,586156,462238,123918,640372,20489,2073759.55,94.55913455,4.486345887
9839377,7299569,3222478,4077091,9245097,299596,11659154.12,81.60044921,3.618070974
10364295,6178436,2045939,4132497,9876896,3079388,4800762.65,90.89266243,2.346483766
17070462,13923385,5479068,8444317,18176681,2554107,18523943.02,89.12350167,3.380856565
3835,39998,22837,17161,58681,12182,760.366667,86.01905417,0.033295383
24,1,1,0,1,0,12.85,100,12.85
831,401,72,329,1194,112,8.483333,37.06099815,0.117824069
753128,448101,251805,196296,528798,73406,169037.35,98.39896177,0.671302595
1114,1386,449,937,1469,20,1090.4,95.65217391,2.428507795
7565,9438,5753,3685,10014,72,42693.98333,94.93059747,7.421168666
125707,87021,27561,59460,87159,86,84404.75,99.94027999,3.06247052
1330559,1383469,443627,939842,1445667,14962,1360064.583,96.69841092,3.065784056
10931,21646,20634,1012,21665,2,135.116667,99.92152518,0.006548254
3515,1815,1104,711,2140,276,507,97.37124464,0.45923913
38,27,19,8,31,3,22.883333,96.42857143,1.204385947
94744,89112,83067,6045,107262,2281,38024,84.88393138,0.457750972
478472,437091,404035,33056,449943,4175,1176088.833,98.05347176,2.910858795
17,13,9,4,17,4,107.233333,100,11.91481478
4674163,3736093,2809271,926822,7565409,302415,2051580.2,51.44012235,0.730289175
4877198,2360649,1206056,1154593,7026043,537711,3145245.483,36.38298718,2.607876818
1476,15877,9264,6613,18012,1668,577.016667,97.14268233,0.06228591
500,567,390,177,603,14,3768.45,96.26485569,9.662692308
70920,49796,11952,37844,53593,3594,34346.85,99.59399188,2.87373243
867,765,261,504,778,13,817.7,100,3.132950192
8048,4213,2055,2158,4926,665,19517.33333,98.87350387,9.497485807
223300,182544,41892,140652,208759,11807,97815.4,92.68451196,2.334942232
751111,650628,190698,459930,676752,23701,464544.0833,99.62897232,2.436019693
1249,3978,1487,2491,4135,142,289.433333,99.6243426,0.194642457
58436,27290,16826,10464,31825,3429,6766.966667,96.10508522,0.402173224
40769,262,77,185,280,2,2.316667,94.24460432,0.030086584
39,31,18,13,33,2,41.25,100,2.291666667
227,65,24,41,103,10,59.866667,69.89247312,2.494444458
13579,5447,3329,2118,6287,330,19046.16667,91.43864361,5.721287674
11,4,3,1,5,1,8.083333,100,2.694444333
51589,18352,7867,10485,24419,1864,33894.83333,81.36555088,4.308482691
1517118,1179430,314169,865261,1746220,175425,618284.6333,75.08490923,1.968000132
26596,3598,2554,1044,4053,240,88.866667,94.36139523,0.034795093
229,70,13,57,229,153,28.766667,92.10526316,2.212820538
2695,1103,567,536,1826,296,294.516667,72.09150327,0.519429748
1132,917,517,400,977,25,1933.2,96.32352941,3.73926499
20790,16624,9260,7364,18033,765,108391.5333,96.27055826,11.70534917
642197,259690,28823,230867,264457,2482,58841.3,99.12777937,2.041470354
3754865,3204584,1205279,1999305,3814568,30192,3920835.317,84.67932362,3.253052046
1749,15198,3652,11546,20023,84,131.883333,76.22247856,0.036112632
4,3,1,2,3,0,0.183333,100,0.183333
127690,59646,41430,18216,99397,7921,21133.56667,65.20398793,0.510102985
426,23,22,1,23,0,46.766667,100,2.125757591
25788,19133,15141,3992,20037,574,15912.23333,98.30447516,1.05093675
19,272,271,1,280,8,0.183333,100,0.000676506
1742,423,319,104,446,18,236.15,98.8317757,0.740282132
5508,1,1,0,1,0,0.183333,100,0.183333
87,3,1,2,4,1,1.133333,100,1.133333
123,4,2,2,11,0,3.766667,36.36363636,1.8833335
280,25,1,24,95,55,4.216667,62.5,4.216667
5992,1326,368,958,2281,767,590.383333,87.58256275,1.604302535
4,644,634,10,646,2,0.633333,100,0.000998948
206,31,31,0,32,1,58.4,100,1.883870968
132,9,4,5,12,1,53.566667,81.81818182,13.39166675
178,60,4,56,64,2,4.483333,96.77419355,1.12083325
15611,11439,1432,10007,14308,999,2862.633333,85.94935758,1.999045624
326,76,3,73,115,37,0,97.43589744,0
2969,434,349,85,524,89,167.366667,99.77011494,0.47956065
13599,11462,4053,7409,13997,66,13421.28333,82.27693633,3.311444198
60301,89941,22688,67253,101558,225,70536.46667,88.75785776,3.108976845
605929,496885,66718,430167,645091,4745,146741.2167,77.59633073,2.199424693
3834566,3334723,552400,2782323,4081830,38865,1501777.783,82.48211399,2.718641896
7538,8332,1929,6403,9783,67,851.166667,85.75545492,0.441247624
48620,29203,16256,12947,39715,9994,6409.966667,98.25712459,0.394313894
125,13,4,9,19,6,10.783333,100,2.69583325
2146,282,146,136,374,78,1104.166667,95.27027027,7.56278539
128814,105163,36262,68901,116105,5433,138913.6833,95.02222784,3.830833471
1777162,1506835,340125,1166710,1661585,80188,493335.9,95.28505492,1.450454686
857,1016,790,226,1037,14,15.95,99.31573803,0.020189873
2606,1165,933,232,1607,226,440.783333,84.35916003,0.472436584
3,3,2,1,3,0,0.35,100,0.175
22,6,3,3,6,0,12.416667,100,4.138889
1210,365,220,145,367,0,521.383333,99.45504087,2.369924241
193550,132399,48160,84239,139153,4948,69080.21667,98.65429753,1.434389881
320164,220427,81219,139208,260524,35199,117616.8167,97.82625097,1.448144112
193,967,767,200,970,2,77.5,99.89669421,0.101043025
3215,1828,1500,328,1979,13,958.716667,92.98067141,0.639144445
20530,2,2,0,3,0,0.35,66.66666667,0.175
18053,17656,17511,145,18316,4,3316.683333,96.41764963,0.189405707
30407,22616,20617,1999,27791,1262,66910.05,85.25010366,3.245382451
31190,15139,7799,7340,19963,4662,36018.81667,98.94124567,4.61838911
471470,210064,109092,100972,231841,15005,546792.5,96.87690236,5.012214461
1809,1998,896,1102,2166,139,124.033333,98.56931426,0.138430059
3881,1380,929,451,2066,675,561,99.20920201,0.603875135
368,336,182,154,346,3,507.7,97.95918367,2.78956044
6936,5533,2786,2747,5691,74,13174.71667,98.50453979,4.728900455
526401,505165,17004,488161,516860,8615,90896.91667,99.39399305,5.345619658
1661150,1515070,209505,1305565,1586731,27041,822587.9833,97.13917509,3.926340581
538,2479,876,1603,3139,23,101.4,79.55712452,0.115753425
69,56,3,53,69,10,1.616667,94.91525424,0.538889
112777,94798,15910,78888,108186,12532,8014.416667,99.10510799,0.503734549
45,24,6,18,28,0,7.966667,85.71428571,1.327777833
1257,233,129,104,291,8,342.116667,82.33215548,2.652067186
3727,61,30,31,118,37,46.683333,75.30864198,1.5561111
166421,42660,21957,20703,90612,1829,19037.51667,48.04973925,0.867036329
7,50,16,34,52,0,0.083333,96.15384615,0.005208313
1086,294,266,28,294,0,257.766667,100,0.96904762
1,1,1,0,1,0,0.916667,100,0.916667
525,385,146,239,481,95,196.683333,99.74093264,1.347146116
782,257,107,150,323,57,305.916667,96.61654135,2.859034271
33563,12789,3740,9049,13163,183,11814.75,98.52850539,3.159024064
90746,35029,15620,19409,68315,32364,37134.28333,97.43539818,2.377354887
32,243,182,61,285,40,7.65,99.18367347,0.042032967
13926,8905,5742,3163,12391,3325,7418.333333,98.22413413,1.291942413
1,1,1,0,1,0,0.766667,100,0.766667
61,27,9,18,29,2,61.833333,100,6.870370333
6287,4886,2364,2522,5385,95,5170.266667,92.36294896,2.187084038
76248,59988,17957,42031,76997,2792,46371.83333,80.84091369,2.582381987
299280,254419,81110,173309,281763,9583,204431.5333,93.47453891,2.520423293
546,1029,337,692,1216,4,22.333333,84.9009901,0.066271018
7657,3553,1129,2424,4348,81,1107.183333,83.26693227,0.980676114
3,3,1,2,3,0,0.95,100,0.95
42,3,3,0,7,4,9,100,3
1142,352,256,96,358,6,757.5,100,2.958984375
1,1,1,0,1,0,3.483333,100,3.483333
1470,250,207,43,296,45,843.016667,99.60159363,4.072544285
47645,22129,16349,5780,25440,3244,47545.6,99.69814381,2.908165637
616,1189,1145,44,1196,6,140.1,99.91596639,0.122358079
537,33,28,5,64,31,13.883333,100,0.495833321
24136,23748,23722,26,23778,5,4456.65,99.89483868,0.18786991
35704,31341,28901,2440,31567,177,338175.9167,99.84389933,11.70118393
23871,22877,6656,16221,23618,278,17726.41667,98.01628106,2.663223658
46449,43277,28999,14278,44177,442,175599.3333,98.95278381,6.055358231
234207,201379,113894,87485,212790,9494,558081.7667,99.05703998,4.900010243
1605,2909,1322,1587,3185,128,227.483333,95.15865227,0.172075138
18750,17094,9119,7975,17825,669,11510.56667,99.6386104,1.262261944
165072,181561,157228,24333,181980,59,33010.98333,99.80211191,0.209956136
327474,324033,316803,7230,331130,1518,427066.6667,98.30740386,1.348051207
326982,287274,142122,145152,296920,6530,495522.1667,98.92696029,3.486597196
28353,22970,12654,10316,27259,962,46345.85,87.34836673,3.66254544
108239,93317,35206,58111,118985,8428,116228.6833,84.40623389,3.301388494
1116,3205,2580,625,3450,201,345.433333,98.64573715,0.133888889
142,117,105,12,193,10,500.666667,63.93442623,4.768253971
9375,1851,1132,719,4781,2903,1074.15,98.56230032,0.94889576
46,36,28,8,40,0,61.2,90,2.185714286
2780,1893,1159,734,2195,227,6460.95,96.18902439,5.574590164
1249,845,382,463,900,29,5791.1,97.01492537,15.15994764
34856,24978,15304,9674,26972,571,41740.36667,94.61005265,2.727415491
500,527,522,5,545,4,134.933333,97.41219963,0.258492975
3447,2083,1593,490,2781,682,1116.983333,99.23773225,0.701182255
28,19,6,13,21,0,3.733333,90.47619048,0.622222167
1380,655,334,321,803,20,1715.35,83.65261814,5.135778443
26474,20644,8625,12019,21584,39,15091.36667,95.81805523,1.749723672
115896,61309,24704,36605,70451,296,125599.7333,87.39077756,5.084186097
395,626,429,197,756,8,13.1,83.68983957,0.030536131
2917,841,482,359,1173,329,487.466667,99.64454976,1.011341633
159,119,83,36,122,0,661.733333,97.54098361,7.972690759
61278,45025,25865,19160,45814,184,65201.75,98.6741179,2.520848637
94645,67044,27950,39094,72876,686,85103.65,92.87158886,3.044853309
1892,1815,576,1239,1935,44,51.016667,95.98096245,0.088570602
5366,2158,1610,548,2865,377,902.566667,86.73633441,0.560600414
687,489,13,476,628,1,35.65,77.99043062,2.742307692
19265,17404,7748,9656,18323,362,22036.46667,96.89883637,2.844149028
242087,164711,58602,106109,178339,11541,56739.36667,98.74878596,0.968215533
150559,116989,64105,52884,124683,4054,58434.71667,96.98248348,0.911546941
467,2247,1390,857,2285,23,92.9,99.33687003,0.066834532
115351,81022,35265,45757,106019,24399,13473.96667,99.26733644,0.382077603
4364,13,6,7,13,0,3.933333,100,0.6555555
49,25,20,5,27,2,153.316667,100,7.66583335
49666,48561,40686,7875,50434,880,28341.11667,97.99612544,0.696581543
230173,229648,122456,107192,265658,20717,704803.25,93.75645564,5.755563223
25,24,20,4,26,1,30.533333,96,1.52666665
6846437,3440331,422588,3017743,5716663,1884917,1051223.717,89.78494399,2.487585347
7541396,4401573,1592007,2809566,5723758,1049280,3684511.783,94.16180801,2.314381647
10286,8723,6392,2331,10787,256,444.9,82.83163992,0.069602628
88,51,11,40,88,30,1.583333,87.93103448,0.143939364
70379,15065,8718,6347,15342,264,8176.016667,99.91378167,0.937831689
7519,12,5,7,15,1,53.633333,85.71428571,10.7266666
106,68,45,23,68,0,170.083333,100,3.779629622
351,173,108,65,194,2,975.983333,90.10416667,9.036882713
9176,7604,5615,1989,7829,13,6387.3,97.28761515,1.137542297
556773,435502,40959,394543,535730,1180,71959.56667,81.47076981,1.75686825
460,1286,460,826,1536,26,402.033333,85.16556291,0.873985507
14193,11410,6634,4776,12789,1013,1442.233333,96.8919837,0.217400261
395,306,177,129,336,8,168.366667,93.29268293,0.951224107
4735,594,328,266,1168,94,1307.05,55.30726257,3.984908537
134203,96617,52026,44591,107360,10090,111164.5833,99.32867277,2.136712093
1134257,1070496,602489,468007,1159243,19526,599021.45,93.92647473,0.994244625
794,3315,1829,1486,3394,52,89.316667,99.19210054,0.048833607
25841,19733,6242,13491,23224,3444,2666.55,99.76238625,0.427194809
9724,27286,468,26818,27303,16,562.716667,99.99633525,1.202386041
10699,9787,6927,2860,9950,156,35734.01667,99.92852767,5.158656946
809448,543169,200186,342983,554020,4200,706637.5333,98.79033138,3.529904855
2274029,1868495,782390,1086105,2019886,117193,2663821.367,98.20265277,3.404723177
1097,3088,1557,1531,3263,139,140.016667,98.84763124,0.089927211
1261,1167,394,773,1307,134,738.483333,99.48849105,1.87432318
585,6,6,0,6,0,28.916667,100,4.8194445
7737,5384,2080,3304,5497,42,8966.066667,98.6984418,4.310608975
158232,18660,7385,11275,21981,566,24985.45,87.13518562,3.383270142
26,44,42,2,45,1,12.166667,100,0.289682548
336,19,10,9,25,6,6.166667,100,0.6166667
224,103,36,67,110,7,4.283333,100,0.118981472
6471,561,461,100,584,3,1650.55,96.55765921,3.580368764
8461,4392,3117,1275,5753,1043,9524.116667,93.24840764,3.055539515
212611,119285,72030,47255,176344,44661,76070.25,90.58496541,1.056091212
1095,376,297,79,450,50,53.583333,94,0.180415263
15741,12837,10198,2639,16308,3285,2054.2,98.57175766,0.201431653
303,78,23,55,103,20,15.883333,93.97590361,0.690579696
630,121,41,80,155,25,161.2,93.07692308,3.931707317
85932,21633,10036,11597,30354,515,20255.18333,72.49907839,2.018252624
158677,104404,50957,53447,115168,6301,25023.48333,95.90050245,0.491070576
14,1253,1240,13,1269,5,160.083333,99.12974684,0.129099462
30215,20360,8466,11894,27310,6779,3546.25,99.16711315,0.418881408
307,245,161,84,252,1,881.4,97.60956175,5.474534161
4605,3675,2560,1115,3908,78,19029.03333,95.95300261,7.433216146
39525,1061,468,593,1182,55,1475.666667,94.14374445,3.153133904
200097,156909,34734,122175,170358,1723,124999.3,93.04652059,3.598759141
467,849,757,92,862,1,97.283333,98.60627178,0.128511668
45,16,3,13,83,5,1.483333,20.51282051,0.494444333
88477,66867,33338,33529,104528,2116,11725.21667,65.29215326,0.351707261
2,2,2,0,2,0,8.333333,100,4.1666665
111,102,59,43,107,4,128.35,99.02912621,2.175423729
180,137,94,43,146,9,108.2,100,1.15106383
17688,17021,11597,5424,18466,262,18853.05,93.50142826,1.625683366
10,65,16,49,66,1,0,100,0
499,486,464,22,500,11,117.433333,99.38650307,0.25308908
380,8,7,1,9,0,36.483333,88.88888889,5.211904714
7,5,5,0,6,1,2.233333,100,0.4466666
47626,46814,45105,1709,48076,143,12408.75,97.66549142,0.275108081
292440,163459,124339,39120,185796,13890,1574527.017,95.08626808,12.66317902
11069887,4277241,904335,3372906,4674170,342750,2572455.383,98.74916309,2.844582354
42448582,23619825,9283001,14336824,31285146,5632784,12834807.73,92.07660877,1.382614063
3418,17381,15470,1911,17812,255,557.833333,98.99755083,0.036059039
31,14,7,7,17,2,22,93.33333333,3.142857143
142011,74753,31392,43361,107286,28442,61549.53333,94.81127289,1.960675756
49,1,1,0,1,0,0.233333,100,0.233333
444,25,21,4,26,1,66.5,100,3.166666667
6026,2768,1813,955,3167,129,6259.333333,91.11257406,3.452472881
63974,28266,16491,11775,33456,1818,62635.75,89.34193059,3.798177794
281,281,277,4,285,1,64.566667,98.94366197,0.233092661
78,1,1,0,1,0,1.333333,100,1.333333
12,2,2,0,2,0,5.783333,100,2.8916665
1270,877,488,389,1139,49,1522.65,80.4587156,3.120184426
84433,52144,24977,27167,54748,1947,60075.46667,98.75570538,2.40523148
465868,327493,132091,195402,349001,9177,304943.9,96.37135694,2.308589533
1054,1746,1079,667,1803,21,175.4,97.97979798,0.162557924
4590,1532,1255,277,2040,502,392.35,99.60988296,0.312629482
18,10,7,3,11,1,15.2,100,2.171428571
2477,1631,1432,199,1807,112,20472.58333,96.22418879,14.29649674
1078,644,315,329,730,50,1097.583333,94.70588235,3.484391533
43353,25149,16829,8320,34129,6220,41665.26667,90.11071697,2.475801692
134,192,124,68,234,42,13.533333,100,0.109139782
22,24,20,4,24,0,231.483333,100,11.57416665
855,193,146,47,322,127,186.533333,98.97435897,1.277625568
87,42,13,29,81,39,44.783333,100,3.444871769
1586,835,283,552,1264,424,1934.483333,99.4047619,6.835630152
7686,5203,2040,3163,9246,104,4692.483333,56.91314811,2.300236928
102420,79210,37894,41316,95963,14311,132855.4667,97.00925881,3.50597632
883,998,928,70,1011,10,144.266667,99.7002997,0.15545977
5792,4920,2191,2729,5270,340,5501.616667,99.79716024,2.511007151
10,2,1,1,2,0,10.666667,100,10.666667
1066,554,301,253,743,106,1222.833333,86.97017268,4.062569213
9781,4619,1826,2793,5966,129,6542.7,79.13311633,3.583077766
14050,10395,3248,7147,11889,930,5830.75,94.85354503,1.79518165
377,443,383,60,448,3,8.216667,99.5505618,0.021453439
6290,3271,1935,1336,5007,1730,1231.983333,99.81690571,0.636683893
86,18,1,17,32,0,1.833333,56.25,1.833333
3831,3660,1976,1684,4853,9,31414.05,75.55739059,15.89779858
41064,24134,6098,18036,29070,158,27856.6,83.47399004,4.568153493
4,5,5,0,5,0,0.516667,100,0.1033334
3130,5250,66,5184,5275,25,34.816667,100,0.527525258
3302,1,1,0,1,0,4.416667,100,4.416667
8,2,1,1,2,0,0.3,100,0.3
1399,1116,684,432,1256,3,1760.983333,89.06624102,2.574537037
19780,11823,7713,4110,13246,119,73713.5,90.06627562,9.557046545
67,25,14,11,28,3,79.266667,100,5.661904786
1248006,973725,400566,573159,1133048,9796,896053.55,86.68802726,2.236968564
1168972,920790,448778,472012,1085751,13974,3024494.617,85.91246127,6.739400364
2556,10279,4606,5673,11284,90,652.25,91.8259782,0.141608771
61483,50534,31886,18648,53399,1843,13278.63333,98.0176895,0.416440862
11297,679,40,639,981,3,115.4,69.42740286,2.885
51496,24681,10401,14280,28791,245,25412.98333,86.4604498,2.443321155
23424,19808,6060,13748,22555,1168,7346.566667,92.61701033,1.212304731
476261,192477,23332,169145,393404,2186,41317.25,49.19942334,1.770840477
276,1276,1045,231,1296,9,202.616667,99.14529915,0.193891547
12519,7807,1524,6283,9772,1667,1901.433333,96.32325725,1.247659667
2603,15,4,11,15,0,33.716667,100,8.42916675
10,9,5,4,10,0,8.033333,90,1.6066666
523,191,55,136,335,143,112.4,99.47916667,2.043636364
11275,3385,1443,1942,5200,1693,3687.5,96.52124323,2.555440055
142595,120870,25324,95546,128431,3027,17765.53333,96.38448534,0.701529511
539702,293800,64304,229496,351688,49879,94791.9,97.34633493,1.474121361
405,3563,3219,344,3648,55,124.466667,99.16504314,0.038666253
25270,27111,4193,22918,27336,162,1641.45,99.76816074,0.391473885
3500,3354,32,3322,3390,0,68.183333,98.9380531,2.130729156
32225,27925,9755,18170,28144,17,22526.01667,99.28182885,2.309176491
208538,203112,67502,135610,204070,144,193449.45,99.6008356,2.865832864
333000,310320,88024,222296,316683,470,315832.6833,98.13638275,3.588029212
371,383,348,35,391,5,82.116667,99.22279793,0.235967434
7438,3596,2717,879,5684,2077,2086.116667,99.69503743,0.767801497
26984,27,18,9,58,23,136.516667,77.14285714,7.584259278
220,1,1,0,1,0,0,100,0
3095,3,2,1,52,45,1.2,42.85714286,0.6
292,239,131,108,312,21,377.116667,82.13058419,2.878753183
6051,3419,1740,1679,3585,28,8646.216667,96.12032612,4.969090039
2046345,1921273,329587,1591686,1995663,17007,988516.5833,97.09990013,2.999258415
13479292,12837202,2851431,9985771,13789678,281318,8695038.583,95.03153603,3.049359631
754,37205,10930,26275,39355,680,378.983333,96.19909502,0.034673681
388146,124188,46299,77889,133183,6539,63706.7,98.0607056,1.375984363
16,9,9,0,13,4,80.233333,100,8.914814778
5814,4973,3542,1431,5605,462,44770.06667,96.69453626,12.63977037
51225,6322,4071,2251,9592,3261,14190.46667,99.85784236,3.485744698
143916,65018,24002,41016,80093,10868,92506.23333,93.92271578,3.854105213
40,49,30,19,59,6,2.466667,92.45283019,0.082222233
8814,3605,2636,969,5961,2222,1867.433333,96.41615405,0.708434497
45154,47,42,5,47,0,26.1,100,0.621428571
49,38,21,17,42,3,14.816667,97.43589744,0.705555571
16716263,2800330,1572296,1228034,9484903,5584650,385902.5333,71.79867562,0.245438857
763177,684949,630765,54184,750483,30005,2966779.85,95.06869051,4.703463017
16,9,8,1,11,2,50.016667,100,6.252083375
935311,579216,412523,166693,869179,200048,918174.1333,86.56242201,2.225752584
162474,100255,68649,31606,117482,11755,424343.8333,94.82440625,6.181354912
7821411,6856903,4294299,2562604,7707794,273950,19059642.72,92.23899506,4.438359489
5950,11890,7739,4151,21975,6967,712.533333,79.22441365,0.092070466
2725,1750,300,1450,2604,30,66.266667,67.98756799,0.22088889
6814,2525,1598,927,2787,124,1534.35,94.81787458,0.960168961
37,28,26,2,28,0,37.033333,100,1.424358962
798,656,319,337,731,60,1482.016667,97.76453055,4.645820273
1790,904,108,796,1320,21,340.016667,69.59199384,3.148302472
70011,6176,2797,3379,8041,1208,9749.333333,90.38489682,3.485639375
261,280,258,22,303,11,65.933333,95.89041096,0.255555554
698,490,437,53,547,57,147.166667,100,0.336765828
73015,69904,68834,1070,72454,2515,14005.95,99.94995639,0.2034743
1145443,1923258,163909,1759349,2039202,104449,49938.35,99.40586731,0.30467119
397636,376765,335579,41186,394523,6616,346828.1167,97.12766204,1.033521516
57,47,39,8,54,7,188.033333,100,4.821367513
1232023,802963,157020,645943,1056987,141449,342440.7833,87.70395112,2.180873668
4099865,1907418,562885,1344533,2270364,267535,1445517.267,95.23618841,2.568050786
5200,17324,6930,10394,18497,1014,3327.033333,99.0905451,0.48009139
8,2,1,1,2,0,0.4,100,0.4
1904,1891,1864,27,1941,7,710.083333,97.77662875,0.380945994
1388,1385,1381,4,1387,0,3337.883333,99.85580389,2.417004586
322567,72188,21818,50370,83724,3114,16974.06667,89.55216474,0.777984539
66,10,8,2,13,3,15.633333,100,1.954166625
3202,1078,800,278,1356,261,2249.883333,98.44748858,2.812354166
48382,44300,31344,12956,45876,1512,70446.88333,99.85573889,2.247539667
225162,125658,91029,34629,134296,8348,183867.3167,99.76974624,2.019876267
358,829,794,35,835,6,78.366667,100,0.098698573
4636,3753,1556,2197,3967,200,1235.9,99.62835147,0.794280206
126,113,44,69,117,0,49.483333,96.58119658,1.124621205
1068,181,74,107,219,10,456,86.60287081,6.162162162
7576,3190,487,2703,5408,18,957.833333,59.18367347,1.966803559
406790,345030,100689,244341,369773,1436,152221.5333,93.67237068,1.511799038
574,5532,5344,188,5618,9,814.416667,98.62720628,0.152398328
984,150,54,96,178,24,52.033333,97.4025974,0.963580241
227878,151,33,118,351,179,105.366667,87.79069767,3.192929303
1453,1124,442,682,1381,55,1008.516667,84.76621418,2.281711916
67393,60633,26504,34129,68387,3189,110163.5333,92.99825148,4.156487071
2149338,1411562,400570,1010992,1510878,70100,688687.35,97.97220668,1.719268418
2775230,2657315,750386,1906929,2800068,50071,1424839.517,96.62974178,1.898808769
940,53283,17051,36232,54123,199,1078.066667,98.81128996,0.063226008
1042126,920830,371121,549709,974159,49467,340803.9667,99.58234742,0.918309572
5,1,1,0,1,0,0.266667,100,0.266667
201,143,135,8,146,0,67.233333,97.94520548,0.498024689
1507,1209,1178,31,1255,0,605.766667,96.33466135,0.514233164
1,7,7,0,7,0,0,100,0
177,71,64,7,71,0,20.183333,100,0.315364578
124,98,28,70,104,5,113.366667,98.98989899,4.048809536
762,564,162,402,574,1,491.35,98.42931937,3.033024691
80004,76006,19061,56945,80313,2263,81039.68333,97.38116592,4.251596628
17676,16106,5193,10913,17096,544,12590.95,97.30546158,2.424600424
1,37,30,7,38,1,0,100,0
179,265,80,185,269,4,72.7,100,0.90875
5,5,5,0,5,0,3.533333,100,0.7066666
73137,72165,71411,754,72527,290,24521.26667,99.90032809,0.343382205
369828,356045,344406,11639,361141,3208,525402.1167,99.47252698,1.525531253
710729,324471,151220,173251,452058,119375,418977.7167,97.53158412,2.770650157
3309065,2794909,1432722,1362187,3736613,349982,2872480.233,82.52770969,2.004911095
2522,6695,4791,1904,8113,1184,820.883333,96.62288931,0.171338621
22,12,1,11,16,4,2.033333,100,2.033333
616,196,28,168,643,27,1434.016667,31.81818182,51.21488096
27646,10512,144,10368,21696,7522,86.516667,74.16396218,0.600810188
6403,15,15,0,17,0,75.5,88.23529412,5.033333333
77,77,76,1,77,0,518.35,100,6.820394737
291,1,1,0,24,23,0.5,100,0.5
5557,10,1,9,1158,1135,9.9,43.47826087,9.9
2451,392,375,17,2018,1621,305.366667,98.74055416,0.814311112
12686,12764,3415,9349,13943,95,11587.78333,92.17215482,3.393201562
59089,51672,32497,19175,56696,499,128405.8333,91.94796875,3.951313455
624339,586343,28316,558027,607882,4231,65274,97.13278036,2.305198474
2153312,1931878,236644,1695234,2034825,9191,657449.1167,95.37152319,2.778220097
1638,8177,6035,2142,8342,56,689.083333,98.68452812,0.114181165
201,58,1,57,280,76,0.133333,28.43137255,0.133333
103402,53566,46038,7528,68740,10457,11821.26667,91.90673095,0.256771942
785,701,99,602,792,3,109.933333,88.84664132,1.110437707
4334,5333,235,5098,5642,4,226.85,94.59028024,0.965319149
678,95,61,34,100,0,250.783333,95,4.11120218
9,9,5,4,9,0,4.85,100,0.97
13362,14508,10726,3782,14785,76,2748.8,98.6334897,0.256274473
683023,161282,50329,110953,219992,880,301654.2,73.60710504,5.993645811
27,7,6,1,12,5,3.666667,100,0.611111167
18669371,17788894,5135575,12653319,18227080,164823,26782082.08,98.48655127,5.215011383
3715034,3575879,1058690,2517189,3962541,34481,5453529.45,91.03422555,5.151205216
21941,14229,7987,6242,14705,148,1411.35,97.74678849,0.176705897
141229,87613,33477,54136,104014,11131,57349.98333,94.32619532,1.71311597
484,17,9,8,26,7,6.583333,89.47368421,0.731481444
1458,654,414,240,766,33,3229.7,89.22237381,7.801207729
12568,4237,2227,2010,5039,297,7829.55,89.35048503,3.515738662
262,248,210,38,260,0,55.766667,95.38461538,0.265555557
85,25,16,9,40,15,3.233333,100,0.202083313
4,3,1,2,4,1,0.733333,100,0.733333
56,7,5,2,9,2,5.316667,100,1.0633334
1896,337,165,172,359,10,742,96.56160458,4.496969697
29902,19711,7784,11927,19836,114,23827.36667,99.94422472,3.061069716
225737,126582,52911,73671,128693,1808,89143.1,99.76120109,1.684774433
675,780,587,193,782,1,73.133333,99.87195903,0.124588302
4329,221,105,116,221,0,68.666667,100,0.653968257
2,1,1,0,1,0,0.983333,100,0.983333
12128,11950,11822,128,11951,0,2242.766667,99.9916325,0.189711273
19939,18121,16187,1934,18351,200,118286.5833,99.83471985,7.307504994
1,1,1,0,1,0,0.55,100,0.55
45323,41756,22892,18864,42695,531,116132.25,99.03234987,5.073049537
462886,295088,168407,126681,317679,7113,424692.1,95.01619624,2.521819758
491,1109,967,142,1115,2,115.05,99.64061096,0.118976215
21802,19608,11353,8255,20226,214,10081.78333,97.98121127,0.888028128
43,50,13,37,53,3,24.116667,100,1.855128231
3,3,3,0,3,0,1.266667,100,0.422222333
671,45,22,23,48,0,69.633333,93.75,3.1651515
3606,611,269,342,835,112,862.133333,84.50899032,3.204956628
57189,55869,28105,27764,59990,2178,27877.25,96.63910607,0.99189646
272,515,328,187,519,0,66.45,99.22928709,0.202591463
10987,9764,9655,109,9764,0,3254.383333,100,0.33706715
12,2,1,1,4,2,0.883333,100,0.883333
2892,1360,897,463,1521,88,10135.76667,94.90579204,11.29962839
347582,207013,95551,111462,247706,33153,603283.6333,96.48571682,6.313734376
317416,180289,86595,93694,218420,28854,568225.5,95.10618993,6.561874242
1044,906,827,79,946,32,84.85,99.12472648,0.102599758
6574,562,333,229,980,392,639.716667,95.57823129,1.921071072
26028,1,1,0,1,0,0.4,100,0.4
79,54,38,16,56,1,33.416667,98.18181818,0.879385974
4178,2761,2437,324,2836,51,719.833333,99.13824057,0.295376829
48890,36094,31021,5073,37547,655,142576.25,97.83692942,4.59612037
79,30,25,5,33,2,336.283333,96.77419355,13.45133332
1520283,988720,433816,554904,1133356,122091,1746989.117,97.77061403,4.027027857
1163605,798525,440665,357860,920984,97654,2486681.267,96.98723477,5.643019679
1181,10115,5088,5027,10155,34,187.633333,99.94071732,0.03687762
35903,24300,10364,13936,26864,1810,46708.3,96.99050052,4.506783095
1843155,1390897,293452,1097445,1407068,13400,985838.1167,99.80117216,3.35945271
30,23,13,10,23,0,6.866667,100,0.528205154
273524,242952,62606,180346,312117,29844,37977.88333,86.06986853,0.60661731
285248,188572,92107,96465,225420,28906,640116.75,95.95855766,6.949707948
17,3,3,0,5,2,3.55,100,1.183333333
11417695,10764015,2759392,8004623,11984700,209254,11162480.33,91.41067778,4.045268064
3835743,3401759,1016635,2385124,3854417,255855,4150251.217,94.53106546,4.082341466
6793,18730,11934,6796,19581,538,2373.583333,98.35635142,0.19889252
199890,195595,191074,4521,205929,4158,1393354.017,96.93910423,7.292221949
198970,196522,75838,120684,200210,1535,68538.26667,98.91632062,0.903745704
5890,9,7,2,9,0,42.35,100,6.05
19,16,8,8,18,1,5.583333,94.11764706,0.697916625
73735,81090,71281,9809,81497,208,20487.63333,99.75519443,0.287420678
536836,474288,386115,88173,494178,12007,1162141.633,98.36510284,3.009832908
1,1,1,0,1,0,0.05,100,0.05
1341518,1143989,380818,763171,1241972,41167,318577.65,95.26850738,0.836561428
679589,516212,295446,220766,594058,54665,2972966.683,95.70239139,10.06263982
10001543,8793463,5362500,3430963,10301499,909446,23981905.02,93.62663307,4.47215012
3733,20444,6713,13731,24501,1795,695.5,90.03787545,0.103604946
49,21,16,5,21,0,33.716667,100,2.107291688
119976,41901,17516,24385,68144,24994,13342.55,97.10544612,0.761734985
1324,1260,627,633,1313,10,1589.75,96.69992325,2.535486443
57779,52525,35179,17346,54693,1221,274800.05,98.22897965,7.81147986
798975,433844,303140,130704,451903,14767,443820.6833,99.24691629,1.464078259
2253870,2075248,1314404,760844,2157175,55495,13713539.5,98.74233946,10.43327584
496826,408546,204075,204471,431103,13567,812620.6,97.84689224,3.981970354
1191,27259,26757,502,27565,220,8108.166667,99.68550009,0.303029737
5,1,1,0,1,0,17.183333,100,17.183333
418911,214589,101894,112695,248434,27818,74483.45,97.26810385,0.730989558
43996,4,2,2,4,0,0.683333,100,0.3416665
7817,6794,4007,2787,7764,357,5076.05,91.72404482,1.266795608
62432,58634,35461,23173,59611,862,71080.3,99.80425199,2.004464059
81485,263,130,133,266,1,393.533333,99.24528302,3.027179485
839409,827404,395167,432237,834698,6324,308295.6833,99.88290313,0.780165559
4132,1305,1289,16,1306,0,117.283333,99.92343032,0.090987846
11,3,2,1,3,0,0.433333,100,0.2166665
2645,1949,1741,208,2586,635,1074.016667,99.89748847,0.61689642
762,4,2,2,4,0,0.783333,100,0.3916665
14168,13453,4685,8768,14547,100,15833.33333,93.11967883,3.37958022
30326,26316,15662,10654,28402,437,86472.71667,94.10334347,5.521179713
545183,418661,109943,308718,425162,2846,147340.8667,99.13453433,1.340156869
6885177,6595396,601877,5993519,7375025,57349,1229833.733,90.12965318,2.043330669
1414,28140,3119,25021,28531,84,244.933333,98.92080008,0.078529443
423,288,33,255,424,74,54.983333,82.28571429,1.666161606
77058,62007,15842,46165,67110,505,9880.65,93.09661437,0.623699659
268,238,120,118,274,26,28.533333,95.96774194,0.237777775
1420,1351,1038,313,1401,16,3649.4,97.54512635,3.515799615
6844,6303,1382,4921,7264,188,2616.583333,89.07574901,1.893330921
91193,64727,34842,29885,91467,22075,50174.05,93.27732303,1.440045061
14,114,63,51,129,13,1.7,98.27586207,0.026984127
11951,8566,5948,2618,10894,2028,2265.1,96.61628694,0.380817081
1462,2,2,0,2,0,31.633333,100,15.8166665
75,51,30,21,52,1,21.933333,100,0.7311111
12983,13382,12173,1209,13425,13,3608.3,99.77631971,0.296418303
77909,57955,37020,20935,62045,1354,394476.8,95.49191808,10.65577526
100,55,53,2,57,0,514.633333,96.49122807,9.710062887
4699753,3042977,1260896,1782081,3114274,39850,4610980.883,98.97714173,3.65690817
4639610,4246015,1945130,2300885,4704325,233342,8367014.3,94.96826537,4.301519333
2469,18758,8053,10705,21641,1769,714.1,94.39412238,0.088675028
30611,28224,12911,15313,28548,125,44078.85,99.29986279,3.414053908
185947,11,6,5,12,0,16.333333,91.66666667,2.722222167
36,33,21,12,33,0,24.216667,100,1.153174619
179554,178110,177203,907,182864,63,34072.13333,97.43382148,0.192277407
363278,343200,315603,27597,349615,1657,418408.5333,98.63259359,1.325743207
30,8,6,2,8,0,9.083333,100,1.513888833
164356,134200,70674,63526,155512,7744,742220.55,90.81803909,10.50203116
3183521,2817164,1061496,1755668,3193004,138496,4254934.117,92.22971425,4.008431607
3317,12044,4692,7352,13017,378,546.183333,95.29234908,0.11640736
79546,61352,46140,15212,69749,8179,13259.58333,99.64593146,0.287377185
75,38,19,19,42,4,81.966667,100,4.314035105
2045,985,361,624,1048,27,1526.183333,96.47404505,4.227654662
10108,5948,1539,4409,6078,1,5419.866667,97.87724206,3.521680745
320580,303191,89553,213638,306156,1591,287174.3333,99.54886477,3.206752798
466,812,540,272,884,66,24.8,99.26650367,0.045925926
16780,8118,3765,4353,9579,758,3827.533333,92.03038204,1.016609119
46,14,6,8,80,0,9.033333,17.5,1.5055555
1747,1343,720,623,2367,64,2590.583333,58.31524099,3.598032407
7425,5839,1963,3876,6000,37,6065.8,97.92050981,3.090066225
168033,131074,44536,86538,224397,5277,183079.3833,59.81836437,4.11081784
253,400,290,110,401,1,66.183333,100,0.22821839
1202,224,164,60,526,302,86.483333,100,0.527337396
558,113,24,89,304,3,50.55,37.54152824,2.10625
2999,827,726,101,840,0,857.016667,98.45238095,1.180463729
102205,77637,64485,13152,82176,69,36358.83333,94.55588439,0.563833967
260,896,853,43,913,0,80.366667,98.13800657,0.094216491
5125,2282,1885,397,2412,129,1078.233333,99.95619799,0.572007073
163,18,9,9,22,2,28.85,90,3.205555556
10501,2477,1827,650,3891,1336,6864.033333,96.94716243,3.756996898
22459,1271,608,663,2840,1529,2254.383333,96.94889397,3.707867324
3,1,1,0,4,3,0,100,0
436,143,42,101,316,173,54.7,100,1.302380952
2,2,2,0,2,0,8.35,100,4.175
2653,766,373,393,1006,227,1615.833333,98.33119384,4.33199285
4,273,271,2,274,1,0.25,100,0.000922509
97,87,6,81,87,0,0.65,100,0.108333333
54218,49852,19844,30008,62131,1010,59029.23333,81.56280166,2.974664046
109084,83993,46234,37759,105315,2798,254753.9167,81.93080172,5.510098989
16585633,15399375,1553369,13846006,15947525,143753,2191115.417,97.4411362,1.410556936
22966823,20832817,2809376,18023441,24148544,678781,5011311.667,88.76449668,1.783781048
1316,72102,11910,60192,77631,3218,369.733333,96.89435986,0.031043941
796,551,14,537,796,113,7.333333,80.67349927,0.5238095
193092,152952,61335,91617,173357,11772,46132.4,94.65730111,0.752138257
1183,1149,456,693,1206,3,662.9,95.51122195,1.45372807
3780,2190,1088,1102,2300,15,11739.51667,95.84245077,10.78999694
187395,90677,19605,71072,96321,430,35415.6,94.56257626,1.806457536
241671,223089,66652,156437,239277,1931,100691.3167,93.99315767,1.510702104
845,2002,970,1032,2100,81,90.15,99.15799901,0.092938144
95451,62684,16635,46049,86039,22971,17741.86667,99.39113338,1.066538423
91,84,61,23,85,0,477.95,98.82352941,7.835245902
6795,4626,2457,2169,4927,136,20517.78333,96.55604258,8.350746167
97696,79644,42397,37247,81570,1169,122230.3667,99.05846942,2.882995652
383739,311568,143321,168247,324800,4584,799638.6667,97.29932296,5.579354503
735,1657,800,857,1819,91,96.5,95.8912037,0.120625
16,11,2,9,16,2,0.216667,78.57142857,0.1083335
7628,1943,923,1020,6304,2418,535.866667,50,0.580570603
11,11,7,4,12,0,6.333333,91.66666667,0.904761857
94,31,16,15,33,2,57.933333,100,3.620833313
1812,401,188,213,452,34,1101.933333,95.93301435,5.861347516
1,1,1,0,1,0,2.316667,100,2.316667
2328,1710,433,1277,1839,119,1448.533333,99.41860465,3.34534257
302124,99476,63669,35807,110788,7114,89196.96667,95.95076876,1.400948133
930,287,236,51,311,11,3.816667,95.66666667,0.016172318
2671,369,346,23,406,36,105.283333,99.72972973,0.30428709
181,175,73,102,182,5,105.333333,98.8700565,1.44292237
222,137,70,67,141,2,701.333333,98.56115108,10.01904761
7775,6541,4914,1627,6631,86,4236.65,99.93888464,0.862159137
209290,139179,57196,81983,153140,9449,121531.1667,96.8599286,2.124819335
11,1134,570,564,1152,15,8.216667,99.73614776,0.014415205
46801,45026,1112,43914,49859,4459,495.583333,99.17621145,0.445668465
40935,33887,26527,7360,35375,436,112887.4,96.98903804,4.255566027
1245,1225,1057,168,1229,3,7885.75,99.91843393,7.460501419
298106,310664,253009,57655,326678,3790,141772.7333,96.21416714,0.560346602
161,34,25,9,43,6,58.5,91.89189189,2.34
1142406,1138006,871758,266248,1172634,13360,5737284.8,98.16540352,6.581281502
2734,2546,2258,288,2711,162,12928.7,99.88230679,5.725730735
312780,308488,133753,174735,317563,4433,989986.95,98.51754862,7.401605571
230890,230890,230890,0,230890,0,45149.2,100,0.195544199
3547603,3089148,1327064,1762084,3575514,232304,8402206.017,92.40065685,6.331424872
22287,17732,12859,4873,18235,233,106095.45,98.50016665,8.250676569
48236,47060,45983,1077,51815,1362,309880.8,93.27492914,6.739029641
102563,81776,15756,66020,92430,5633,26292.28333,94.21523785,1.668715622
221,18,12,6,26,8,62.3,100,5.191666667
708,347,257,90,399,31,554.533333,94.29347826,2.157717249
4923,2996,2004,992,3526,323,5629.1,93.53730877,2.808932136
92976,16911,9571,7340,21372,1571,24439.75,85.40477754,2.553521053
4,15,15,0,34,6,0.95,53.57142857,0.063333333
5972,3000,2420,580,4053,976,1928.783333,97.49756256,0.797017906
265,2,1,1,2,0,0.483333,100,0.483333
18097,17932,17885,47,17952,10,3442.3,99.94426485,0.192468549
26436,24428,21449,2979,25204,495,121905.75,98.86276256,5.683516714
314432,252903,153207,99696,293122,37703,282810.8333,99.0149519,1.845939372
1466247,1366295,719642,646653,1434432,45765,3125529.2,98.38895862,4.3431723
1916,2555,1807,748,2900,276,267.75,97.37042683,0.148173769
16,12,5,7,13,0,27.05,92.30769231,5.41
7251,2376,170,2206,2694,233,524.466667,96.54611946,3.085098041
15204,14765,14600,165,14816,15,2781.233333,99.75677319,0.190495434
22099,11117,9917,1200,12125,542,12985.88333,95.97686264,1.309456825
2,2,2,0,2,0,7.15,100,3.575
91209,19049,5537,13512,20181,892,17249.5,98.75576754,3.115315153
49200,33354,13664,19690,35345,1048,44260.86667,97.25048838,3.239232045
377841,284767,100201,184566,343376,24221,197039.3,89.22529805,1.966440455
959,2574,1425,1149,2916,297,123.383333,98.28178694,0.086584795
73,45,7,38,77,5,19.55,62.5,2.792857143
26840,10589,4183,6406,16825,1309,3519.333333,68.24568188,0.84134194
1456,709,404,305,917,192,439.9,97.79310345,1.088861386
28611,16847,9467,7380,21737,4014,25560.46667,95.05727021,2.699954227
259,296,219,77,371,72,48.15,98.99665552,0.219863014
369,23,15,8,36,13,0.683333,100,0.045555533
3892,5,1,4,5,0,0.933333,100,0.933333
8,1,1,0,2,1,2.433333,100,2.433333
151,88,32,56,89,0,71.616667,98.87640449,2.238020844
102521,79295,24306,54989,80763,92,42514.6,98.2943065,1.74914013
1501411,1110700,364895,745805,1126488,1623,510155.5333,98.74073778,1.398088583
1421,3243,1778,1465,3658,133,21.083333,92,0.011857893
43590,31948,6027,25921,41289,4522,6187.4,86.89313787,1.026613572
104302,5266,4039,1227,5624,295,11626.76667,98.81778945,2.878625072
14,13,13,0,13,0,9.516667,100,0.732051308
137533,66098,28247,37851,103449,28435,29747.61667,88.11421868,1.053124816
576643,490754,450231,40523,514129,6069,663051.2833,96.5937094,1.472691315
1,1,1,0,1,0,0.033333,100,0.033333
179973,143458,60959,82499,149497,4364,168300.2667,98.84588619,2.760876436
1855273,1465259,861462,603797,1690828,61115,2335175.5,89.90902079,2.710712138
6941,8782,7040,1742,9629,549,427.183333,96.71806167,0.060679451
497,331,166,165,1029,48,1597.45,33.74108053,9.623192771
263010,247953,99062,148891,268812,16793,75337.31667,98.38662958,0.76050672
230,2,2,0,2,0,8.833333,100,4.4166665
1,1,1,0,1,0,1.616667,100,1.616667
13487,12954,11335,1619,13230,177,4427.2,99.24155367,0.390577856
107896,94129,65917,28212,99173,2620,491540.6333,97.48946175,7.456963049
1,1,1,0,1,0,4.983333,100,4.983333
658454,576811,154705,422106,806631,204267,416615.0333,95.75788062,2.692964244
1459754,1228682,688863,539819,1340321,54790,2614688.717,95.5777807,3.795658522
24862,37604,14936,22668,39732,643,4441.066667,96.20097726,0.297339761
481,479,479,0,479,0,911.816667,100,1.903583856
831,81,22,59,847,514,7.133333,24.32432432,0.324242409
62823,39976,23282,16694,59645,11282,76528.1,82.65823047,3.28700713
7,2,2,0,4,1,0.333333,66.66666667,0.1666665
1655,934,568,366,1082,22,1287.733333,88.11320755,2.26713615
72854,1683,395,1288,1732,32,2677.183333,99,6.777679324
421188,380514,93576,286938,426950,25498,194941.4167,94.78443251,2.083241608
196,1123,166,957,1757,632,0.066667,99.82222222,0.000401608
16072,8942,2655,6287,8968,7,5163.916667,99.78797009,1.944978029
20317,326,126,200,374,5,1529.916667,88.34688347,12.14219577
29,14,7,7,14,0,35.366667,100,5.052381
85513,81474,77209,4265,84962,1703,34031.91667,97.85608763,0.44077655
617332,575565,485498,90067,600988,8632,1764376.383,97.16538703,3.634157882
42,6,6,0,8,2,69.983333,100,11.66388883
2035404,2015532,1155507,860025,2057074,30109,1830313.883,99.43595474,1.583992034
3254550,2622381,1538376,1084005,2965446,229501,4466704.117,95.84918556,2.903519111
9487519,4895212,2314709,2580503,9160976,2532819,4275907.45,73.85479855,1.847276461
30929,23732,5680,18052,36935,7747,1292.366667,81.3073866,0.227529343
11,1,1,0,1,0,3.933333,100,3.933333
28210,504,164,340,28947,3383,4913.25,1.971522453,29.95884146
1469687,1025363,374222,651141,1459465,376270,317618.8333,94.66097979,0.848744417
15,10,4,6,10,0,1.766667,100,0.44166675
6651,6320,6101,219,6377,8,1672,99.23064845,0.274053434
28939,16629,8259,8370,18488,230,33316.68333,91.07788367,4.033985147
4,3,2,1,3,0,26.266667,100,13.1333335
1172077,1039288,223094,816194,1194833,38442,838806.0667,89.87340787,3.759877301
5193722,4835801,1310681,3525120,5293629,8966,4683370.2,91.50632689,3.573234219
8772,18301,4361,13940,25412,352,349.666667,73.02873105,0.080180387
61503,38548,15885,22663,55364,6963,10831.86667,79.64298258,0.681892771
127,1,1,0,1,0,0.633333,100,0.633333
657,215,199,16,215,0,68.35,100,0.343467337
1527,235,72,163,487,249,487.516667,98.7394958,6.771064819
13,1,1,0,1,0,0.016667,100,0.016667
207,97,70,27,103,6,40.133333,100,0.573333329
4636,3359,2262,1097,3708,42,1616.45,91.62575014,0.714610964
2676,1946,1064,882,2116,161,2486.816667,99.53964194,2.33723371
49732,26207,12246,13961,29379,1843,49285.3,95.17359094,4.024603952
7,31,27,4,36,0,1.1,86.11111111,0.040740741
24,9,4,5,12,3,2.2,100,0.55
51,1,1,0,1,0,1.033333,100,1.033333
1736,3,2,1,7,4,4.133333,100,2.0666665
3077,46,23,23,50,4,21.516667,100,0.935507261
22322,886,511,375,1114,144,1621.066667,91.34020619,3.172341814
4,166,164,2,167,1,2.25,100,0.013719512
784,12,5,7,27,15,4.95,100,0.99
1378,733,346,387,842,71,1039.966667,95.07133593,3.005684009
6039,5541,2385,3156,5909,356,8334.816667,99.78390059,3.494682041
70264,53492,23578,29914,56742,2891,111564.8167,99.33334571,4.731733678
5,70,54,16,71,1,3.216667,100,0.059567907
792,1161,74,1087,1161,0,40.816667,100,0.551576581
36,32,9,23,40,3,13.416667,86.48648649,1.490740778
1169,588,224,364,648,48,756.683333,98,3.378050594
733884,634820,289448,345372,645285,1841,222246.9833,98.65971242,0.767830434
2968148,2701997,583710,2118287,3170622,27136,1644813.333,85.95543292,2.817860467
393,8479,2896,5583,11942,21,213.7,71.12658334,0.073791436
1076787,912564,405251,507313,967432,34053,351379.7667,97.76993054,0.867066995
106,23,11,12,24,1,26.583333,100,2.416666636
520,267,171,96,368,94,687.016667,97.44525547,4.017641327
5652,4121,2197,1924,4666,522,8923.65,99.44498069,4.061743286
104905,79834,50250,29584,91365,1700,20679.78333,89.03585569,0.411537977
330,296,276,20,299,3,71.45,100,0.258876812
1599,1451,769,682,1457,0,547.45,99.58819492,0.71189857
13,10,4,6,11,1,13.666667,100,3.41666675
999,374,202,172,490,87,1461.666667,92.80397022,7.235973599
73903,62021,17264,44757,63501,201,27715.53333,97.97946288,1.605394656
106804,89191,41837,47354,93037,2154,72545.06667,98.13826568,1.733993036
242,209,177,32,216,4,2.633333,98.58490566,0.014877588
14471,7495,7065,430,10445,2936,2131.466667,99.81355706,0.301693796
642151,295730,295730,0,295730,0,71842.45,100,0.242932574
78,68,65,3,68,0,22.25,100,0.342307692
81079,79557,77492,2065,80501,481,41434.9,99.42139465,0.534699066
486417,462141,434386,27755,483650,6778,1397231.767,96.9109111,3.216567216
12,12,12,0,12,0,14.683333,100,1.223611083
2985894,2750965,975531,1775434,3113581,225448,966108.7667,95.25063423,0.990341431
4431213,3797142,1669670,2127472,4809516,441903,4148978.6,86.93860926,2.484909353
3740,21615,9057,12558,29289,4105,1052.366667,85.82830368,0.116193736
9,1,1,0,5,4,78.816667,100,78.816667
952,459,155,304,1066,260,1987.233333,56.94789082,12.82086021
802819,783554,232700,550854,810830,6760,21706.73333,97.44848085,0.093282051
64499,3,3,0,3,0,3.483333,100,1.161111
88,31,18,13,32,0,11.95,96.875,0.663888889
4054810,1474528,683080,791448,1745978,198921,129921.7333,95.31180816,0.190199879
1942152,1982906,651449,1331457,2146468,48332,1835774.883,94.50798232,2.817987108
105,37,35,2,45,8,88.1,100,2.517142857
91187,59459,40002,19457,60456,592,112747.5,99.32346652,2.818546573
1898295,451432,244254,207178,568695,64230,334362.55,89.4872786,1.368913303
4087932,2436301,913409,1522892,2600010,129393,2658983.667,98.61103522,2.911054814
9252,19370,9908,9462,23643,2902,877.666667,93.38990405,0.088581618
2101,2001,1888,113,2347,9,56861.06667,85.58597092,30.1170904
1180269,22139,15365,6774,25003,2655,10439.31667,99.06479327,0.679421846
34,15,5,10,15,0,15.083333,100,3.0166666
861,208,51,157,238,29,84.633333,99.5215311,1.659477118
127607,93981,26337,67644,98320,563,83417.26667,96.13736101,3.167303287
1438136,1413120,562641,850479,1489677,8299,917217.4,95.39226315,1.630200074
277,656,298,358,659,0,4.533333,99.5447648,0.015212527
141521,135115,21326,113789,135527,100,126018.8333,99.76961758,5.909164088
13358,12888,12624,264,13371,68,3820.816667,96.88040292,0.302662917
59371,61171,36197,24974,64489,2199,358261.3667,98.20356397,9.897543074
1145627,867023,234033,632990,1218682,241244,579240.2,88.70363133,2.475036426
11430017,6781792,2087036,4694756,9573497,2179460,5400035.467,91.7197466,2.587418457
1515,17148,16294,854,17227,61,1707.5,99.89514156,0.104793175
5,2,1,1,6,4,1.25,100,1.25
29131,21932,9134,12798,25290,2321,11770.78333,95.48521921,1.288677834
940,112,64,48,135,7,446.533333,87.5,6.977083328
12974,9634,3138,6496,14210,1004,3552.8,72.95168863,1.132186106
344605,225156,85250,139906,342853,11841,94854.56667,68.02049473,1.112663539
337,545,427,118,676,36,68.066667,85.15625,0.159406714
9413,2400,392,2008,5307,2467,4648.966667,84.50704225,11.85960884
550,394,317,77,416,10,5345.483333,97.04433498,16.86272345
3643,1878,917,961,3085,129,6257.25,63.53179973,6.823609597
183081,33107,8328,24779,37596,188,17628.88333,88.50245937,2.116820765
207318,163148,62842,100306,184921,7092,92651.58333,91.74431617,1.474357648
850,975,781,194,1018,16,71.216667,97.30538922,0.091186513
70756,40363,28385,11978,43540,429,18536.95,93.62575677,0.65305443
22,20,6,14,20,0,1.916667,100,0.3194445
4138,3517,637,2880,3739,79,1272.216667,96.09289617,1.997200419
0,3,3,0,4,1,0,100,0
3214,56,5,51,56,0,23.933333,100,4.7866666
5,3,1,2,3,0,1.933333,100,1.933333
21070,14332,13467,865,14754,335,9556.433333,99.39662945,0.709618574
134749,89156,43685,45471,95087,5109,263247.7667,99.08644335,6.02604479
1064,1055,1015,40,1055,0,23382.08333,100,23.0365353
584499,396254,153448,242806,416450,17125,374890.2,99.23095223,2.443109066
1265517,680139,242643,437496,757470,73114,687974.05,99.38380024,2.835334421
936,2338,1507,831,2828,403,299.833333,96.41237113,0.198960407
78800,40394,18803,21591,51280,10465,115109.8833,98.96851648,6.121889238
106,99,14,85,104,2,17.083333,97.05882353,1.220238071
18664,17110,6677,10433,21958,738,3831.366667,80.63147974,0.573815586
13,143,140,3,144,0,1.433333,99.30555556,0.010238093
29,7,7,0,7,0,2.95,100,0.421428571
750,188,98,90,335,75,473.633333,72.30769231,4.832993194
9690,5234,2281,2953,9275,3840,1860.9,96.30174793,0.815826392
744826,473609,318630,154979,749161,250129,180233.1667,94.90553712,0.565650336
117,1504,1257,247,1568,8,52.066667,96.41025641,0.041421374
18246,1254,718,536,1638,250,288.583333,90.34582133,0.401926648
116,1,1,0,1,0,0.25,100,0.25
370,164,81,83,187,19,25.066667,97.61904762,0.309465025
12894,9757,7849,1908,10073,43,4305.833333,97.2781655,0.548583684
1,14,10,4,16,0,0,87.5,0
65,39,17,22,67,28,11.5,100,0.676470588
46,26,1,25,38,0,0.033333,68.42105263,0.033333
3194,3740,1256,2484,3814,3,1450.166667,98.13697192,1.154591295
46994,56072,18574,37498,58200,161,27365.73333,96.61089957,1.473335487
155,527,95,432,530,3,0.15,100,0.001578947
11702,2363,1457,906,2522,154,816.633333,99.78885135,0.56048959
839,794,647,147,813,18,1311.083333,99.87421384,2.026403915
12201,9650,8131,1519,10491,632,14345.8,97.88010954,1.76433403
28591,18424,12109,6315,19430,852,60530.85,99.17106255,4.998831448
323789,275389,187251,88138,289624,11020,1016498.117,98.84603236,5.42853238
498,800,755,45,826,15,112.983333,98.64364982,0.149646799
713,208,105,103,221,13,266.283333,100,2.536031743
15844,3,2,1,3,0,25.283333,100,12.6416665
204,174,85,89,202,14,122.45,92.55319149,1.440588235
7137,5177,2670,2507,5930,248,16191.73333,91.11228441,6.0643196
2,2,2,0,2,0,4.883333,100,2.4416665
8425,7486,3777,3709,7636,74,9703.066667,98.99497487,2.568987733
1524153,1487903,313977,1173926,1531523,24468,364652.5167,98.7291771,1.161398818
666,2307,1633,674,2375,25,170.983333,98.17021277,0.104705042
9965,12368,4511,7857,12531,94,11886.21667,99.44520383,2.634940516
37,31,19,12,33,2,22.316667,100,1.174561421
22228,21438,17959,3479,21622,158,10365.05,99.87886694,0.577150732
96628,51727,32943,18784,55286,3026,216000.0833,98.9800995,6.556782422
25,17,13,4,29,3,56.05,65.38461538,4.311538462
164365,55415,22714,32701,62631,4854,158330.4167,95.91186804,6.970609169
2997503,2623600,953025,1670575,2678236,40521,4263617.983,99.46487774,4.473773493
1925,5625,4118,1507,5852,142,307.633333,98.51138354,0.074704549
28,12,7,5,15,2,8.633333,92.30769231,1.233333286
129,89,25,64,154,12,61.45,62.67605634,2.458
68538,52360,23658,28702,64515,8144,18143.11667,92.88463926,0.766891397
47,1,1,0,1,0,7.433333,100,7.433333
1152,141,91,50,156,2,335.5,91.55844156,3.686813187
24446,1922,1031,891,2674,130,10298.56667,75.55031447,9.988910443
179370,83912,27307,56605,98156,3137,47157.95,88.3107589,1.726954627
8657,258,81,177,262,1,3.266667,98.85057471,0.040329222
1211,242,145,97,313,70,176.533333,99.58847737,1.217471262
615,220,3,217,222,0,7.433333,99.0990991,2.477777667
1371,942,588,354,1044,37,1932.1,93.54518371,3.285884354
5543,4503,2241,2262,4534,18,6347.483333,99.71213463,2.832433437
67451,36908,16733,20175,39965,140,45969.2,92.67545512,2.747218072
252,266,263,3,266,0,66.083333,100,0.251267426
393,128,85,43,268,140,63.083333,100,0.742156859
596,43,42,1,43,0,13.866667,100,0.330158738
100932,65842,65366,476,65860,14,38421.4,99.99392522,0.587788759
5,8,8,0,8,0,0,100,0
4725,1221,851,370,1230,9,566.133333,100,0.665256561
2,2,1,1,2,0,0.316667,100,0.316667
235,171,85,86,189,18,199.666667,100,2.349019612
4925,3359,1875,1484,3707,72,9505.183333,92.40715268,5.069431111
284572,112940,47030,65910,114130,582,81416.45,99.46454363,1.731159898
1303071,1054195,306481,747714,1118345,23740,770784.2833,96.30825732,2.514949649
4312,3334,2338,996,3481,97,121.7,98.52245863,0.052053037
96834,1752,1080,672,37457,35350,907.533333,83.15140009,0.840308642
222622,544,498,46,555,9,3041.566667,99.63369963,6.107563588
9543136,5872808,3835780,2037028,6569078,688880,1352480.033,99.87432396,0.35259583
821002,612469,481262,131207,678464,45425,459111.25,96.75059515,0.953973615
1090,659,563,96,794,119,2498.866667,97.62962963,4.438484311
34519290,22349934,15089492,7260442,25560170,1540034,46741121.48,93.04665885,3.097594106
3462,3389,3150,239,3466,52,10585.3,99.26772115,3.360412698
10,10,6,4,10,0,17.633333,100,2.938888833
80472467,53364681,25365291,27999390,72877853,18390168,39900876.82,97.93897649,1.573050229
114898098,73474021,46239304,27234717,94428999,16439616,97463290.27,94.21028629,2.107801845
594823,462258,353678,108580,516139,36672,62705.1,96.41080617,0.177294319
635,43,16,27,170,122,26.5,89.58333333,1.65625
65666,63122,60904,2218,74928,1240,738029.9,85.661166,12.11792165
2660,1,1,0,1,0,57.966667,100,57.966667
18230034,7940438,2712038,5228400,12630217,4557589,1206055.8,98.36249112,0.44470461
9231,9208,8981,227,9284,9,2050.283333,99.27762803,0.228291207
23801,19797,12309,7488,20662,513,152275.7167,98.25301504,12.37108755
38952,30292,7058,23234,31050,569,35523.2,99.3799416,5.033040521
727028,703048,173049,529999,758794,43499,472443.6167,98.28783928,2.730114688
2044,4560,1829,2731,5231,59,309.65,88.16705336,0.169300164
32443,24379,9947,14432,25712,969,17086.86667,98.52887685,1.717790959
3868,14,14,0,14,0,151.366667,100,10.81190479
106392,99641,45958,53683,110931,4640,118353.25,93.74359071,2.575248053
294976,230452,131080,99372,278677,14465,808670.2833,87.22238203,6.169288094
6953871,5383575,1178087,4205488,5858010,164121,2334099.3,94.55005182,1.98126225
23622129,21503649,3987705,17515944,24326018,540204,10704325.87,90.40535253,2.684332433
1842,45189,8331,36858,50684,3495,546.5,95.76172413,0.065598368
24,1,1,0,7,2,3.933333,20,3.933333
1559,1076,346,730,1844,370,357.05,72.99864315,1.031936416
90820,73279,37676,35603,80384,6444,27273.7,99.10603192,0.723901157
4952980,69975,56969,13006,72073,1654,309319.2833,99.36948835,5.429607038
70558302,58813076,41176364,17636712,60826050,1760338,35120509.18,99.57227977,0.852928859
2339,2322,2071,251,2340,15,314.866667,99.87096774,0.152036054
37187,5684,5193,491,5844,62,13752.81667,98.30508475,2.648337506
16917433,15273160,10833401,4439759,15529953,174026,60542791.4,99.46100942,5.588530453
772244,738922,674281,64641,752930,13642,12750979.85,99.95049291,18.91048369
45761338,35110874,23107796,12003078,36611627,1140552,109106885.8,98.9845219,4.721648302
55421482,32237698,18913325,13324373,32973775,569470,112451119.3,99.48584918,5.945602865
1683675,813313,516510,296803,1075914,54280,1833946.85,79.60903807,3.550651197
1719,796,761,35,808,12,6384.616667,100,8.38977223
343054,331458,305578,25880,347953,8123,2169683.6,97.53641527,7.100261144
4184,716,630,86,724,2,3617.35,99.16897507,5.741825397
947760,890640,643350,247290,925606,32900,329798.9833,99.76856882,0.512627626
126,2,1,1,19,0,0.333333,10.52631579,0.333333
2524,316,1,315,2872,47,0.533333,11.18584071,0.533333
113873,50701,48983,1718,38031,15,451617.7667,133.3675295,9.219887852
2105,56,24,32,118,34,19.55,66.66666667,0.814583333
398,398,304,94,398,0,105.933333,100,0.348464911
155,78,72,6,136,54,133.316667,95.12195122,1.851620375
1496,11,3,8,15,0,0,73.33333333,0
296,262,184,78,286,22,156.133333,99.24242424,0.848550723
5410,3705,3113,592,4110,310,20924.73333,97.5,6.721726095
152487,291151,26710,264441,326504,15570,120661.85,93.63755652,4.517478472
829997,803899,336513,467386,915305,57858,687457.9833,93.75494929,2.042886852
693,1970,1447,523,2119,110,91.716667,98.05873569,0.063384013
4095,1276,662,614,3525,1965,1041.516667,81.79487179,1.573288017
628,518,39,479,615,96,38.616667,99.80732177,0.990170949
28952,26414,21704,4710,26984,333,24845.6,99.11072755,1.144747512
1752,1202,623,579,1202,0,2921,100,4.688603531
38007,35605,23958,11647,37103,1060,52287.3,98.78478484,2.182456799
249,536,533,3,536,0,103.75,100,0.194652908
3369,1940,1293,647,3224,1280,1160.516667,99.79423868,0.897538026
77,33,13,20,33,0,68.583333,100,5.275641
4457,1944,968,976,3449,234,5079.3,60.46656299,5.247210744
20066,12371,9311,3060,15219,443,28085.98333,83.72360585,3.016430387
1165248,1148795,334336,814459,1329678,6401,155319.6667,86.81440092,0.464561599
736,2953,797,2156,3089,22,139.733333,96.28301272,0.175324132
1605,1038,549,489,1145,75,1498.95,97.00934579,2.730327869
12,6,4,2,6,0,3.15,100,0.7875
70,18,13,5,18,0,6.583333,100,0.506410231
1399,134,73,61,239,89,233.45,89.33333333,3.197945205
5,3,3,0,3,0,1.05,100,0.35
731,156,140,16,159,0,56.183333,98.11320755,0.401309521
10136,3034,2932,102,3153,0,2418.866667,96.22581668,0.824988631
118,680,679,1,683,1,24.616667,99.70674487,0.036254296
1996,849,637,212,1053,204,1425.633333,100,2.238042909
23,2,1,1,3,1,1.083333,100,1.083333
186,33,22,11,33,0,25.533333,100,1.160606045
11192,7125,4876,2249,7700,310,19702.15,96.41407307,4.040637818
1,1,1,0,1,0,0.816667,100,0.816667
613091,549140,197532,351608,592531,4737,806725.9833,93.4238866,4.084026807
1146377,872693,317225,555468,1031146,19278,1645368.45,86.24573561,5.1867553
1046,2811,2446,365,2818,2,289.8,99.82244318,0.11847915
31625,13156,3050,10106,14507,1302,9064.3,99.62892844,2.971901639
36,22,13,9,24,1,8.9,95.65217391,0.684615385
2107,1463,715,748,1641,100,3188.933333,94.93835172,4.46004662
39585,24813,13474,11339,29903,2641,93659.3,91.01679994,6.951113255
21,14,11,3,22,1,44.566667,66.66666667,4.051515182
748303,402877,98856,304021,537670,125658,859986.1333,97.78283157,8.699382266
3521899,2380078,886624,1493454,2732006,192222,2781948.9,93.71182746,3.13768734
1255,5374,4145,1229,5735,292,304.216667,98.73231674,0.073393647
188694,23460,13560,9900,27086,3365,11695.13333,98.89970912,0.86247296
255,2,1,1,2,0,9.6,100,9.6
17947,290,178,112,462,130,252.066667,87.34939759,1.416104871
3,4,4,0,4,0,0,100,0
24,9,1,8,11,1,2.35,90,2.35
1203,348,100,248,360,1,222.316667,96.93593315,2.22316667
5305904,4468457,1018964,3449493,5570972,10577,3053414.433,80.36222247,2.996587155
11243461,9797332,1954843,7842489,10813239,52894,4998493.15,91.05035201,2.556979333
433,48334,5642,42692,58050,42,200.45,83.32298993,0.035528181
63192,41299,17966,23333,48480,6937,6904.316667,99.41265677,0.384299046
11272,8553,235,8318,8576,22,661.883333,99.98830956,2.816524821
53099,44837,13750,31087,48122,1965,37163.76667,97.14019542,2.702819394
57365,46858,13445,33413,49379,111,26257.46667,95.10838678,1.95295401
359177,343862,74960,268902,362185,10725,105169.3667,97.83816081,1.403006492
737,771,689,82,783,8,85.666667,99.48387097,0.124334785
38922,13274,3792,9482,16434,1829,2729.5,90.88668264,0.719804852
1325,1112,30,1082,1153,37,96.05,99.64157706,3.201666667
48929,47024,25699,21325,47652,533,83347.63333,99.79838282,3.243224769
814847,409010,227287,181723,412710,1059,119798.15,99.35843712,0.527078759
943733,524351,148716,375635,860150,252704,380226.6833,86.32059475,2.556730166
583,3425,1570,1855,5027,871,71.733333,82.41097209,0.045690021
223342,139550,77401,62149,207376,5509,34574.5,69.12967449,0.446693195
