Incoming Attempts,Normal Term Seizures,Answered Calls,Normal Not Answer Calls,Outgoing Seizures,FEV Seizures,Network Conversation Minutes,NER,ACD,New Pricing Service
41,41,40,1,41,0,14.533333,100,0.363333325,Call Center
239,49,11,38,71,14,36.666667,85.96491228,3.333333364,Call Center
8019,459,188,271,643,103,1435.066667,85,7.633333335,Corporate
10,8,8,0,8,0,13.133333,100,1.641666625,Corporate
117,96,13,83,112,4,64.016667,88.88888889,4.924359,Call Center
4214,1528,612,916,2300,446,3424.033333,82.41639698,5.594825708,Corporate
503,369,92,277,387,4,275.7,96.34464752,2.99673913,Call Center
8252,5697,2106,3591,5873,84,6721.85,98.41077906,3.191761633,Corporate
9,4,3,1,4,0,28.25,100,9.416666667,Corporate
80,26,10,16,26,0,53.816667,100,5.3816667,Call Center
346,224,131,93,234,8,586.2,99.11504425,4.47480916,Corporate
39,16,10,6,18,2,110.95,100,11.095,Call Center
863,474,209,265,536,36,631.633333,94.8,3.022169057,Corporate
824,900,284,616,936,17,389.1,97.93253536,1.370070423,Call Center
2820,1260,451,809,1992,43,1916.1,64.64853771,4.248558758,Corporate
318,3,1,2,24,0,0.183333,12.5,0.183333,Call Center
640,186,86,100,226,0,325.383333,82.30088496,3.783527128,Corporate
533,197,4,193,208,0,4.316667,94.71153846,1.07916675,Call Center
1012,497,314,183,615,21,1360.5,83.67003367,4.332802548,Corporate
15593,15260,14697,563,15471,121,4553.583333,99.41368078,0.309830804,Call Center
134874,71707,60281,11426,114326,28642,428157.0167,83.68773633,7.102686032,Corporate
85,59,40,19,84,10,116.066667,79.72972973,2.901666675,Call Center
1595,1024,524,500,1350,78,2537.433333,80.50314465,4.842430025,Corporate
31,13,10,3,13,0,34.883333,100,3.4883333,Call Center
2088,1073,733,340,1087,10,2753.7,99.62859796,3.75675307,Corporate
1,1,1,0,1,0,0.266667,100,0.266667,Call Center
4802595,3149114,2595802,553312,4701688,1443039,689671.7167,96.63863767,0.265687335,Call Center
242098,257230,193164,64066,265067,2693,111201.6,98.03943988,0.57568491,Call Center
1357460,1185322,1034636,150686,1266629,54280,4649564.9,97.77069144,4.493913705,Corporate
25,13,12,1,16,2,65.983333,92.85714286,5.498611083,Corporate
61646,60992,60450,542,61371,232,13012.93333,99.75956427,0.215267714,Call Center
546757,519223,508483,10740,530502,8622,858281.9333,99.49087913,1.687926506,Corporate
80,14,5,9,21,4,18.733333,82.35294118,3.7466666,Call Center
10038,7892,4601,3291,9447,59,25111.6,84.06476353,5.457856988,Corporate
628,583,499,84,598,14,863.25,99.82876712,1.72995992,Call Center
12058,9865,2197,7668,10006,110,6721.45,99.68674212,3.059376422,Corporate
13,7,6,1,7,0,3.066667,100,0.511111167,Call Center
6635,5744,2015,3729,6891,248,5855.166667,86.4669577,2.905789909,Call Center
16214,10663,6354,4309,11997,229,36789.8,90.61012916,5.790022033,Corporate
2,2,2,0,2,0,0.533333,100,0.2666665,Corporate
20494,16320,7426,8894,20378,660,18501.15,82.76701491,2.491401831,Call Center
23850,19250,9011,10239,23713,1663,29972.28333,87.3015873,3.326188362,Corporate
268,169,45,124,211,28,125.033333,92.34972678,2.778518511,Call Center
2860,2117,1533,584,2320,47,6592.283333,93.13682358,4.300250054,Corporate
41,37,18,19,37,0,190.733333,100,10.59629628,Call Center
3063,1973,1259,714,2298,73,6466.866667,88.6741573,5.136510458,Corporate
8,8,5,3,8,0,6.6,100,1.32,Call Center
6866089,1421866,689916,731950,3419222,1919628,197643.0833,94.8167304,0.286474126,Call Center
2260506,1767573,973562,794011,2113774,244651,1424319.267,94.56697071,1.462998008,Corporate
1482,547,259,288,550,3,1297.133333,100,5.008236807,Corporate
472,245,105,140,252,2,132.683333,98,1.26365079,Call Center
1386,559,267,292,601,28,590.5,97.55671902,2.211610487,Corporate
787,474,132,342,519,45,355.166667,100,2.690656568,Call Center
6483,1863,1077,786,2148,283,3344.333333,99.89276139,3.105230578,Corporate
63,24,16,8,27,3,68.316667,100,4.269791688,Call Center
2007,660,387,273,721,49,2057.016667,98.21428571,5.315288545,Corporate
54,24,17,7,24,0,23.266667,100,1.368627471,Call Center
5147,2484,1656,828,2604,59,6308.566667,97.60314342,3.809520934,Corporate
10,2,2,0,3,0,5,66.66666667,2.5,Call Center
1667,1121,594,527,1192,24,2497.616667,95.9760274,4.204741864,Corporate
5,5,4,1,5,0,2.183333,100,0.54583325,Call Center
1140,1082,43,1039,1110,14,156,98.72262774,3.627906977,Call Center
12868,11529,4974,6555,12760,235,16144.6,92.04790419,3.24579815,Corporate
3,3,2,1,3,0,10.9,100,5.45,Corporate
7,5,3,2,5,0,2.166667,100,0.722222333,Call Center
27275,24528,23249,1279,25236,390,9461.383333,98.72011591,0.406958722,Call Center
173710,135579,96846,38733,160178,15023,1139365.867,93.40291413,11.76471787,Corporate
7,5,4,1,7,0,7.933333,71.42857143,1.98333325,Corporate
120,122,43,79,143,2,134.383333,86.5248227,3.125193791,Call Center
1503,1316,482,834,1464,58,1838.783333,93.59886202,3.81490318,Corporate
321,271,29,242,351,0,56.516667,77.20797721,1.948850586,Call Center
1042,595,416,179,733,11,904.166667,82.4099723,2.173477565,Corporate
12736,12377,12132,245,12419,6,2966.166667,99.70998147,0.244491153,Call Center
19452,18424,14321,4103,18959,190,96193.73333,98.16186265,6.716970416,Corporate
353,248,130,118,263,14,213.616667,99.59839357,1.643205131,Call Center
5348,333,189,144,395,46,1519.666667,95.41547278,8.040564376,Corporate
71,17,10,7,31,14,36.283333,100,3.6283333,Call Center
457,72,39,33,74,2,109.683333,100,2.812393154,Corporate
209,37,18,19,42,0,29.2,88.0952381,1.622222222,Call Center
4709,1550,798,752,1837,67,3833.65,87.57062147,4.804072682,Corporate
8,8,8,0,8,0,41.716667,100,5.214583375,Corporate
246,198,101,97,202,1,181.3,98.50746269,1.795049505,Call Center
3715,2199,1137,1062,2296,32,6314.633333,97.12897527,5.553767223,Corporate
4695752,3127546,2116869,1010677,4267612,1057362,1144726.633,97.42375204,0.54076404,Call Center
146,114,105,9,116,1,369.316667,99.13043478,3.51730159,Call Center
1928908,1481407,1113427,367980,1868345,235106,3271314.183,90.70362635,2.938058969,Corporate
142,124,79,45,127,3,75.133333,100,0.951054848,Call Center
785,152,95,57,173,21,1044.516667,100,10.99491228,Corporate
630,583,141,442,819,3,229.516667,71.44607843,1.62777778,Call Center
1917,1530,1180,350,1688,9,4224.116667,91.12567004,3.579759887,Corporate
173,48,28,20,69,20,40.7,97.95918367,1.453571429,Call Center
146,76,57,19,81,3,458.15,97.43589744,8.037719298,Corporate
121,88,36,52,88,0,44.733333,100,1.242592583,Call Center
1075,683,492,191,836,0,2165.4,81.69856459,4.401219512,Corporate
24,22,10,12,22,0,7.15,100,0.715,Call Center
18858,17546,17343,203,17577,9,5118.233333,99.87477231,0.295118107,Call Center
70020,46232,32896,13336,48866,2098,421679.9167,98.85391721,12.81857723,Corporate
2,2,2,0,2,0,0.8,100,0.4,Corporate
25,17,11,6,18,1,12.366667,100,1.124242455,Call Center
138377,27011,21648,5363,74509,824,13527.7,36.65739296,0.624893755,Call Center
812417,456311,278644,177667,1075140,116145,4338287.117,47.58220846,15.56928237,Corporate
28,19,15,4,30,7,253.216667,82.60869565,16.88111113,Corporate
17,11,7,4,11,0,4.433333,100,0.633333286,Call Center
25461,25088,23343,1745,25223,125,4561.4,99.96015619,0.195407617,Call Center
104597,95518,79171,16347,98804,3101,510349.4667,99.80669363,6.446166736,Corporate
6,5,5,0,6,1,1.45,100,0.29,Corporate
37,7,7,0,10,3,4.5,100,0.642857143,Call Center
395,60,28,32,102,31,253.7,84.50704225,9.060714286,Corporate
218,130,61,69,138,2,91.166667,95.58823529,1.494535525,Call Center
1357,427,210,217,499,43,780.283333,93.64035088,3.715634919,Corporate
1,1,1,0,1,0,0.8,100,0.8,Call Center
26,13,8,5,14,0,101.883333,92.85714286,12.73541663,Corporate
125,71,66,5,75,4,124.266667,100,1.882828288,Call Center
31473,26750,23756,2994,28638,1082,593807.5333,97.07504718,24.99610765,Corporate
866,794,416,378,845,13,469.783333,95.43269231,1.129286858,Call Center
4275,2780,1595,1185,3040,82,10454.6,93.98242055,6.55460815,Corporate
10,10,7,3,10,0,5.016667,100,0.716666714,Call Center
15126,14951,13848,1103,15008,12,2619.933333,99.69991998,0.189192182,Call Center
22269,16458,13354,3104,20093,979,21375.26667,86.10442608,1.600663971,Corporate
313,313,313,0,313,0,280.366667,100,0.89574015,Call Center
135,18,18,0,18,0,25.733333,100,1.429629611,Call Center
1225,814,417,397,822,3,2132.1,99.38949939,5.11294964,Corporate
273,271,271,0,273,0,1020.783333,99.26739927,3.766728166,Corporate
9392,9300,9154,146,9356,3,2055.383333,99.4333369,0.224533901,Call Center
6138,5245,3951,1294,5441,51,23520.83333,97.30983302,5.953134228,Corporate
66839,66167,65838,329,66231,45,14753.33333,99.97129302,0.224085381,Call Center
346429,354331,328604,25727,356140,1324,793395.65,99.86330943,2.414443068,Corporate
395,326,143,183,339,1,335.166667,96.44970414,2.343822846,Call Center
2095,872,381,491,1017,26,2672.8,87.99192735,7.015223097,Corporate
72879,71119,70555,564,71265,115,22086.8,99.95643008,0.313043725,Call Center
385892,363491,353381,10110,365970,1625,615747.7833,99.76560677,1.74244734,Corporate
8,7,3,4,8,1,3.95,100,1.316666667,Call Center
46,14,2,12,14,0,3.266667,100,1.6333335,Call Center
1025,188,66,122,195,7,294.116667,100,4.456313136,Corporate
116,47,11,36,66,6,23.483333,78.33333333,2.134848455,Call Center
915,363,164,199,421,12,413.766667,88.75305623,2.522967482,Corporate
13839,13363,12489,874,13696,308,2813.016667,99.81326561,0.225239544,Call Center
28914,18890,16589,2301,19709,707,10765.35,99.41058836,0.648945084,Corporate
126,12,7,5,12,0,41.866667,100,5.980952429,Corporate
258,225,188,37,231,5,861.7,99.55752212,4.583510638,Call Center
92505,71871,64868,7003,72281,252,106585.1167,99.78064391,1.643107798,Corporate
64,58,30,28,58,0,25.15,100,0.838333333,Call Center
3072,1989,659,1330,2185,24,1785.983333,92.04072189,2.710141628,Call Center
97759,57755,36369,21386,65456,599,204266.25,89.04975562,5.616493442,Corporate
37,21,16,5,42,5,87.566667,56.75675676,5.472916688,Corporate
21,14,7,7,16,2,15.116667,100,2.159523857,Call Center
61,27,15,12,29,2,27.45,100,1.83,Call Center
5523,2672,2161,511,2969,267,7513.7,98.88971132,3.476955113,Corporate
4,2,2,0,4,2,41.233333,100,20.6166665,Corporate
3,3,2,1,5,0,2.133333,60,1.0666665,Call Center
170,80,39,41,81,0,76.666667,98.7654321,1.965811974,Call Center
2324,288,179,109,295,0,1175.25,97.62711864,6.565642458,Corporate
5,3,3,0,4,1,2.583333,100,0.861111,Corporate
12,8,6,2,9,1,11.65,100,1.941666667,Call Center
796,45,20,25,70,2,63.833333,66.17647059,3.19166665,Corporate
15160,15059,15011,48,15330,0,2899.183333,98.2322244,0.193137255,Call Center
13866,12684,11554,1130,12999,138,16684.3,98.62374621,1.444028042,Corporate
159,114,43,71,116,1,111.05,99.13043478,2.58255814,Call Center
4203,3409,1532,1877,3428,3,6202.4,99.53284672,4.048563969,Corporate
8221,2,1,1,2,0,0.283333,100,0.283333,Corporate
240,148,40,108,180,23,99.95,94.26751592,2.49875,Corporate
50,47,36,11,47,0,89.4,100,2.483333333,Call Center
1182,807,565,242,842,34,2037.633333,99.87623762,3.606430678,Corporate
70741,79869,69395,10474,81106,258,14979.81667,98.78908569,0.215863054,Call Center
350485,420273,330684,89589,433826,2956,472001.95,97.54055748,1.427350431,Corporate
21,9,5,4,13,2,5.016667,81.81818182,1.0033334,Call Center
2048494,1826151,1322362,503789,2065601,167388,397197.7833,96.20369263,0.300369931,Call Center
21257363,18344600,12005636,6338964,20796544,2120726,8593305.317,98.22648732,0.715772602,Corporate
19,3,2,1,4,0,94.516667,75,47.2583335,Corporate
185,77,47,30,82,5,18.333333,100,0.390070915,Call Center
835,250,206,44,267,17,541.766667,100,2.629935277,Corporate
33,9,8,1,41,0,14.816667,21.95121951,1.852083375,Call Center
760,303,201,102,315,3,1042.166667,97.11538462,5.184908791,Corporate
177,151,79,72,170,3,171.733333,90.41916168,2.173839658,Call Center
2215,1563,870,693,1698,36,8885.066667,94.0433213,10.21272031,Corporate
312,175,105,70,185,1,291.383333,95.10869565,2.775079362,Corporate
97,61,13,48,64,3,31.5,100,2.423076923,Call Center
5990,4083,2715,1368,4371,132,10160.11667,96.31988677,3.742216084,Corporate
206389,201881,196749,5132,204934,1893,83767.63333,99.42868682,0.425758877,Call Center
1213094,1068550,876476,192074,1229355,66983,6972048.183,91.92840158,7.954636731,Corporate
103,56,43,13,69,10,653.55,94.91525424,15.19883721,Corporate
662,483,189,294,497,6,526.15,98.3706721,2.783862434,Call Center
10945,7932,4146,3786,9694,1334,16194.95,94.88038278,3.906162566,Corporate
52,24,21,3,25,1,44.866667,100,2.136507952,Call Center
1589,763,504,259,861,90,2703.566667,98.96238651,5.364219577,Corporate
39,39,22,17,39,0,22.85,100,1.038636364,Call Center
21684,21206,21013,193,21278,25,4379.516667,99.77885475,0.208419391,Call Center
85822,72117,54652,17465,73804,582,374035.25,98.49089072,6.843944412,Corporate
10,10,9,1,11,0,15.916667,90.90909091,1.768518556,Corporate
140,35,21,14,59,18,239.3,85.36585366,11.3952381,Corporate
83,52,9,43,66,0,8.383333,78.78787879,0.931481444,Call Center
860,358,215,143,484,22,680.383333,77.48917749,3.164573642,Corporate
240,223,137,86,236,5,44.316667,96.53679654,0.323479321,Call Center
2259,1310,1106,204,1339,14,3827.716667,98.86792453,3.460864979,Corporate
382,190,108,82,344,154,173.5,100,1.606481481,Call Center
12245,10933,5542,5391,11239,232,5947.016667,99.32770055,1.073081318,Corporate
122,86,43,43,87,0,194.633333,98.85057471,4.526356581,Call Center
8973,4479,2695,1784,4682,135,14184.33333,98.50450847,5.263203463,Corporate
10,9,7,2,9,0,4.433333,100,0.633333286,Call Center
290,193,111,82,202,2,115.95,96.5,1.044594595,Call Center
484,306,199,107,328,1,924.5,93.57798165,4.645728643,Corporate
8,5,5,0,7,2,69.266667,100,13.8533334,Corporate
47,19,8,11,19,0,8.05,100,1.00625,Call Center
205,2,1,1,16,0,1.366667,12.5,1.366667,Corporate
15,7,2,5,7,0,4.983333,100,2.4916665,Call Center
574,229,153,76,274,28,629.65,93.08943089,4.115359477,Corporate
3,3,3,0,3,0,1.416667,100,0.472222333,Call Center
70,23,19,4,23,0,52.65,100,2.771052632,Call Center
2453,861,593,268,906,16,1734.483333,96.74157303,2.924929735,Corporate
86,22,16,6,22,0,23.933333,100,1.495833313,Call Center
5158,1877,1212,665,2151,58,7550.95,89.67988533,6.230156766,Corporate
156346,129213,80816,48397,149749,3916,27880.28333,88.60340252,0.344984698,Call Center
473747,468173,406877,61296,497045,4105,969360.15,94.97565627,2.382440271,Corporate
12,12,5,7,12,0,2.266667,100,0.4533334,Call Center
69960,69290,68799,491,69396,101,14229.26667,99.99278447,0.206823743,Call Center
369693,360816,349185,11631,365633,3921,731787.7833,99.75228911,2.09570223,Corporate
610,570,423,147,602,15,903.483333,97.10391823,2.135894404,Call Center
2784,2090,1217,873,2347,207,8204.733333,97.6635514,6.741769378,Corporate
103,61,31,30,62,0,48.883333,98.38709677,1.57688171,Call Center
838244,766729,51462,715267,956228,3214,120864.4333,80.45306785,2.348615159,Call Center
5156862,4791442,3148162,1643280,5370348,40773,47227806.02,89.90289094,15.00170767,Corporate
24,23,18,5,24,0,56.816667,95.83333333,3.1564815,Corporate
502,502,501,1,502,0,161.283333,100,0.32192282,Call Center
2563,2151,1279,872,2606,170,4328.416667,88.30049261,3.384219443,Call Center
75448,62144,33129,29015,81387,4612,133405.2667,80.9430153,4.026842545,Corporate
239,236,236,0,239,0,245.1,98.74476987,1.038559322,Corporate
5,5,5,0,5,0,273.683333,100,54.7366666,Corporate
425,394,315,79,403,3,565.85,98.5,1.796349206,Corporate
47,42,25,17,50,0,16.383333,84,0.65533332,Corporate
10,7,5,2,7,0,3.533333,100,0.7066666,Call Center
705,58,25,33,87,29,63.3,100,2.532,Call Center
25950,4134,2128,2006,5803,1604,13809.35,98.45201238,6.489356203,Corporate
13,11,11,0,11,0,49.7,100,4.518181818,Corporate
77,54,25,29,54,0,59.266667,100,2.37066668,Call Center
17761,14328,9183,5145,14515,38,15713,98.97078124,1.711096592,Corporate
382724,250684,121021,129663,358165,99085,51860.65,96.75930215,0.428526041,Call Center
725716,687050,626078,60972,713064,16102,2112821.767,98.57782777,3.374694154,Corporate
64,3,1,2,4,1,1.083333,100,1.083333,Corporate
12,7,3,4,8,1,1.433333,100,0.477777667,Call Center
18695,18391,18221,170,18427,32,4709.35,99.97825496,0.258457275,Call Center
79045,68752,58666,10086,73924,4943,665923.9,99.66802453,11.35110456,Corporate
7,6,6,0,6,0,37.4,100,6.233333333,Corporate
78968,78585,73951,4634,80703,566,20030.28333,98.06331657,0.270858857,Call Center
627209,586156,462238,123918,640372,20489,2073759.55,94.55913455,4.486345887,Corporate
1114,1386,449,937,1469,20,1090.4,95.65217391,2.428507795,Call Center
7565,9438,5753,3685,10014,72,42693.98333,94.93059747,7.421168666,Corporate
38,27,19,8,31,3,22.883333,96.42857143,1.204385947,Call Center
94744,89112,83067,6045,107262,2281,38024,84.88393138,0.457750972,Call Center
478472,437091,404035,33056,449943,4175,1176088.833,98.05347176,2.910858795,Corporate
17,13,9,4,17,4,107.233333,100,11.91481478,Corporate
867,765,261,504,778,13,817.7,100,3.132950192,Call Center
8048,4213,2055,2158,4926,665,19517.33333,98.87350387,9.497485807,Corporate
39,31,18,13,33,2,41.25,100,2.291666667,Call Center
227,65,24,41,103,10,59.866667,69.89247312,2.494444458,Call Center
13579,5447,3329,2118,6287,330,19046.16667,91.43864361,5.721287674,Corporate
11,4,3,1,5,1,8.083333,100,2.694444333,Corporate
1132,917,517,400,977,25,1933.2,96.32352941,3.73926499,Call Center
20790,16624,9260,7364,18033,765,108391.5333,96.27055826,11.70534917,Corporate
87,3,1,2,4,1,1.133333,100,1.133333,Call Center
123,4,2,2,11,0,3.766667,36.36363636,1.8833335,Corporate
132,9,4,5,12,1,53.566667,81.81818182,13.39166675,Corporate
13599,11462,4053,7409,13997,66,13421.28333,82.27693633,3.311444198,Call Center
60301,89941,22688,67253,101558,225,70536.46667,88.75785776,3.108976845,Corporate
125,13,4,9,19,6,10.783333,100,2.69583325,Call Center
2146,282,146,136,374,78,1104.166667,95.27027027,7.56278539,Corporate
3,3,2,1,3,0,0.35,100,0.175,Call Center
22,6,3,3,6,0,12.416667,100,4.138889,Call Center
1210,365,220,145,367,0,521.383333,99.45504087,2.369924241,Corporate
18053,17656,17511,145,18316,4,3316.683333,96.41764963,0.189405707,Call Center
30407,22616,20617,1999,27791,1262,66910.05,85.25010366,3.245382451,Corporate
368,336,182,154,346,3,507.7,97.95918367,2.78956044,Call Center
6936,5533,2786,2747,5691,74,13174.71667,98.50453979,4.728900455,Corporate
45,24,6,18,28,0,7.966667,85.71428571,1.327777833,Call Center
1257,233,129,104,291,8,342.116667,82.33215548,2.652067186,Corporate
1,1,1,0,1,0,0.916667,100,0.916667,Call Center
525,385,146,239,481,95,196.683333,99.74093264,1.347146116,Call Center
782,257,107,150,323,57,305.916667,96.61654135,2.859034271,Corporate
1,1,1,0,1,0,0.766667,100,0.766667,Call Center
61,27,9,18,29,2,61.833333,100,6.870370333,Call Center
6287,4886,2364,2522,5385,95,5170.266667,92.36294896,2.187084038,Corporate
3,3,1,2,3,0,0.95,100,0.95,Call Center
42,3,3,0,7,4,9,100,3,Call Center
1142,352,256,96,358,6,757.5,100,2.958984375,Corporate
1,1,1,0,1,0,3.483333,100,3.483333,Corporate
24136,23748,23722,26,23778,5,4456.65,99.89483868,0.18786991,Call Center
35704,31341,28901,2440,31567,177,338175.9167,99.84389933,11.70118393,Corporate
165072,181561,157228,24333,181980,59,33010.98333,99.80211191,0.209956136,Call Center
327474,324033,316803,7230,331130,1518,427066.6667,98.30740386,1.348051207,Corporate
46,36,28,8,40,0,61.2,90,2.185714286,Call Center
2780,1893,1159,734,2195,227,6460.95,96.18902439,5.574590164,Corporate
28,19,6,13,21,0,3.733333,90.47619048,0.622222167,Call Center
1380,655,334,321,803,20,1715.35,83.65261814,5.135778443,Corporate
159,119,83,36,122,0,661.733333,97.54098361,7.972690759,Corporate
687,489,13,476,628,1,35.65,77.99043062,2.742307692,Call Center
19265,17404,7748,9656,18323,362,22036.46667,96.89883637,2.844149028,Corporate
49,25,20,5,27,2,153.316667,100,7.66583335,Call Center
49666,48561,40686,7875,50434,880,28341.11667,97.99612544,0.696581543,Call Center
230173,229648,122456,107192,265658,20717,704803.25,93.75645564,5.755563223,Corporate
25,24,20,4,26,1,30.533333,96,1.52666665,Corporate
106,68,45,23,68,0,170.083333,100,3.779629622,Call Center
351,173,108,65,194,2,975.983333,90.10416667,9.036882713,Corporate
395,306,177,129,336,8,168.366667,93.29268293,0.951224107,Call Center
4735,594,328,266,1168,94,1307.05,55.30726257,3.984908537,Corporate
9724,27286,468,26818,27303,16,562.716667,99.99633525,1.202386041,Call Center
10699,9787,6927,2860,9950,156,35734.01667,99.92852767,5.158656946,Corporate
585,6,6,0,6,0,28.916667,100,4.8194445,Corporate
224,103,36,67,110,7,4.283333,100,0.118981472,Call Center
6471,561,461,100,584,3,1650.55,96.55765921,3.580368764,Corporate
303,78,23,55,103,20,15.883333,93.97590361,0.690579696,Call Center
630,121,41,80,155,25,161.2,93.07692308,3.931707317,Corporate
307,245,161,84,252,1,881.4,97.60956175,5.474534161,Call Center
4605,3675,2560,1115,3908,78,19029.03333,95.95300261,7.433216146,Corporate
2,2,2,0,2,0,8.333333,100,4.1666665,Call Center
111,102,59,43,107,4,128.35,99.02912621,2.175423729,Corporate
7,5,5,0,6,1,2.233333,100,0.4466666,Call Center
47626,46814,45105,1709,48076,143,12408.75,97.66549142,0.275108081,Call Center
292440,163459,124339,39120,185796,13890,1574527.017,95.08626808,12.66317902,Corporate
444,25,21,4,26,1,66.5,100,3.166666667,Corporate
12,2,2,0,2,0,5.783333,100,2.8916665,Call Center
1270,877,488,389,1139,49,1522.65,80.4587156,3.120184426,Corporate
18,10,7,3,11,1,15.2,100,2.171428571,Call Center
2477,1631,1432,199,1807,112,20472.58333,96.22418879,14.29649674,Corporate
87,42,13,29,81,39,44.783333,100,3.444871769,Call Center
1586,835,283,552,1264,424,1934.483333,99.4047619,6.835630152,Corporate
10,2,1,1,2,0,10.666667,100,10.666667,Call Center
1066,554,301,253,743,106,1222.833333,86.97017268,4.062569213,Corporate
86,18,1,17,32,0,1.833333,56.25,1.833333,Call Center
3831,3660,1976,1684,4853,9,31414.05,75.55739059,15.89779858,Corporate
8,2,1,1,2,0,0.3,100,0.3,Call Center
1399,1116,684,432,1256,3,1760.983333,89.06624102,2.574537037,Call Center
19780,11823,7713,4110,13246,119,73713.5,90.06627562,9.557046545,Corporate
67,25,14,11,28,3,79.266667,100,5.661904786,Corporate
11297,679,40,639,981,3,115.4,69.42740286,2.885,Call Center
51496,24681,10401,14280,28791,245,25412.98333,86.4604498,2.443321155,Corporate
10,9,5,4,10,0,8.033333,90,1.6066666,Call Center
523,191,55,136,335,143,112.4,99.47916667,2.043636364,Call Center
11275,3385,1443,1942,5200,1693,3687.5,96.52124323,2.555440055,Corporate
3500,3354,32,3322,3390,0,68.183333,98.9380531,2.130729156,Call Center
32225,27925,9755,18170,28144,17,22526.01667,99.28182885,2.309176491,Corporate
292,239,131,108,312,21,377.116667,82.13058419,2.878753183,Call Center
6051,3419,1740,1679,3585,28,8646.216667,96.12032612,4.969090039,Corporate
16,9,9,0,13,4,80.233333,100,8.914814778,Call Center
5814,4973,3542,1431,5605,462,44770.06667,96.69453626,12.63977037,Corporate
49,38,21,17,42,3,14.816667,97.43589744,0.705555571,Call Center
16716263,2800330,1572296,1228034,9484903,5584650,385902.5333,71.79867562,0.245438857,Call Center
763177,684949,630765,54184,750483,30005,2966779.85,95.06869051,4.703463017,Corporate
16,9,8,1,11,2,50.016667,100,6.252083375,Corporate
37,28,26,2,28,0,37.033333,100,1.424358962,Call Center
798,656,319,337,731,60,1482.016667,97.76453055,4.645820273,Corporate
73015,69904,68834,1070,72454,2515,14005.95,99.94995639,0.2034743,Call Center
1145443,1923258,163909,1759349,2039202,104449,49938.35,99.40586731,0.30467119,Call Center
397636,376765,335579,41186,394523,6616,346828.1167,97.12766204,1.033521516,Corporate
57,47,39,8,54,7,188.033333,100,4.821367513,Corporate
66,10,8,2,13,3,15.633333,100,1.954166625,Call Center
3202,1078,800,278,1356,261,2249.883333,98.44748858,2.812354166,Corporate
126,113,44,69,117,0,49.483333,96.58119658,1.124621205,Call Center
1068,181,74,107,219,10,456,86.60287081,6.162162162,Corporate
1453,1124,442,682,1381,55,1008.516667,84.76621418,2.281711916,Call Center
67393,60633,26504,34129,68387,3189,110163.5333,92.99825148,4.156487071,Corporate
5,1,1,0,1,0,0.266667,100,0.266667,Call Center
124,98,28,70,104,5,113.366667,98.98989899,4.048809536,Call Center
762,564,162,402,574,1,491.35,98.42931937,3.033024691,Corporate
5,5,5,0,5,0,3.533333,100,0.7066666,Call Center
73137,72165,71411,754,72527,290,24521.26667,99.90032809,0.343382205,Call Center
369828,356045,344406,11639,361141,3208,525402.1167,99.47252698,1.525531253,Corporate
77,77,76,1,77,0,518.35,100,6.820394737,Corporate
12686,12764,3415,9349,13943,95,11587.78333,92.17215482,3.393201562,Call Center
59089,51672,32497,19175,56696,499,128405.8333,91.94796875,3.951313455,Corporate
9,9,5,4,9,0,4.85,100,0.97,Call Center
13362,14508,10726,3782,14785,76,2748.8,98.6334897,0.256274473,Call Center
683023,161282,50329,110953,219992,880,301654.2,73.60710504,5.993645811,Corporate
27,7,6,1,12,5,3.666667,100,0.611111167,Corporate
484,17,9,8,26,7,6.583333,89.47368421,0.731481444,Corporate
4,3,1,2,4,1,0.733333,100,0.733333,Call Center
56,7,5,2,9,2,5.316667,100,1.0633334,Call Center
1896,337,165,172,359,10,742,96.56160458,4.496969697,Corporate
2,1,1,0,1,0,0.983333,100,0.983333,Call Center
12128,11950,11822,128,11951,0,2242.766667,99.9916325,0.189711273,Call Center
19939,18121,16187,1934,18351,200,118286.5833,99.83471985,7.307504994,Corporate
1,1,1,0,1,0,0.55,100,0.55,Corporate
43,50,13,37,53,3,24.116667,100,1.855128231,Call Center
671,45,22,23,48,0,69.633333,93.75,3.1651515,Corporate
12,2,1,1,4,2,0.883333,100,0.883333,Call Center
2892,1360,897,463,1521,88,10135.76667,94.90579204,11.29962839,Corporate
79,54,38,16,56,1,33.416667,98.18181818,0.879385974,Call Center
4178,2761,2437,324,2836,51,719.833333,99.13824057,0.295376829,Call Center
48890,36094,31021,5073,37547,655,142576.25,97.83692942,4.59612037,Corporate
79,30,25,5,33,2,336.283333,96.77419355,13.45133332,Corporate
30,23,13,10,23,0,6.866667,100,0.528205154,Call Center
273524,242952,62606,180346,312117,29844,37977.88333,86.06986853,0.60661731,Call Center
285248,188572,92107,96465,225420,28906,640116.75,95.95855766,6.949707948,Corporate
17,3,3,0,5,2,3.55,100,1.183333333,Corporate
19,16,8,8,18,1,5.583333,94.11764706,0.697916625,Call Center
73735,81090,71281,9809,81497,208,20487.63333,99.75519443,0.287420678,Call Center
536836,474288,386115,88173,494178,12007,1162141.633,98.36510284,3.009832908,Corporate
1,1,1,0,1,0,0.05,100,0.05,Corporate
1324,1260,627,633,1313,10,1589.75,96.69992325,2.535486443,Call Center
57779,52525,35179,17346,54693,1221,274800.05,98.22897965,7.81147986,Corporate
7817,6794,4007,2787,7764,357,5076.05,91.72404482,1.266795608,Call Center
62432,58634,35461,23173,59611,862,71080.3,99.80425199,2.004464059,Corporate
14168,13453,4685,8768,14547,100,15833.33333,93.11967883,3.37958022,Call Center
30326,26316,15662,10654,28402,437,86472.71667,94.10334347,5.521179713,Corporate
268,238,120,118,274,26,28.533333,95.96774194,0.237777775,Call Center
1420,1351,1038,313,1401,16,3649.4,97.54512635,3.515799615,Corporate
75,51,30,21,52,1,21.933333,100,0.7311111,Call Center
12983,13382,12173,1209,13425,13,3608.3,99.77631971,0.296418303,Call Center
77909,57955,37020,20935,62045,1354,394476.8,95.49191808,10.65577526,Corporate
100,55,53,2,57,0,514.633333,96.49122807,9.710062887,Corporate
36,33,21,12,33,0,24.216667,100,1.153174619,Call Center
179554,178110,177203,907,182864,63,34072.13333,97.43382148,0.192277407,Call Center
363278,343200,315603,27597,349615,1657,418408.5333,98.63259359,1.325743207,Corporate
30,8,6,2,8,0,9.083333,100,1.513888833,Corporate
75,38,19,19,42,4,81.966667,100,4.314035105,Call Center
2045,985,361,624,1048,27,1526.183333,96.47404505,4.227654662,Corporate
46,14,6,8,80,0,9.033333,17.5,1.5055555,Call Center
1747,1343,720,623,2367,64,2590.583333,58.31524099,3.598032407,Corporate
558,113,24,89,304,3,50.55,37.54152824,2.10625,Corporate
163,18,9,9,22,2,28.85,90,3.205555556,Corporate
2,2,2,0,2,0,8.35,100,4.175,Corporate
54218,49852,19844,30008,62131,1010,59029.23333,81.56280166,2.974664046,Call Center
109084,83993,46234,37759,105315,2798,254753.9167,81.93080172,5.510098989,Corporate
1183,1149,456,693,1206,3,662.9,95.51122195,1.45372807,Call Center
3780,2190,1088,1102,2300,15,11739.51667,95.84245077,10.78999694,Corporate
91,84,61,23,85,0,477.95,98.82352941,7.835245902,Call Center
6795,4626,2457,2169,4927,136,20517.78333,96.55604258,8.350746167,Corporate
11,11,7,4,12,0,6.333333,91.66666667,0.904761857,Call Center
94,31,16,15,33,2,57.933333,100,3.620833313,Call Center
1812,401,188,213,452,34,1101.933333,95.93301435,5.861347516,Corporate
1,1,1,0,1,0,2.316667,100,2.316667,Corporate
181,175,73,102,182,5,105.333333,98.8700565,1.44292237,Call Center
222,137,70,67,141,2,701.333333,98.56115108,10.01904761,Corporate
1245,1225,1057,168,1229,3,7885.75,99.91843393,7.460501419,Call Center
298106,310664,253009,57655,326678,3790,141772.7333,96.21416714,0.560346602,Call Center
1142406,1138006,871758,266248,1172634,13360,5737284.8,98.16540352,6.581281502,Corporate
2734,2546,2258,288,2711,162,12928.7,99.88230679,5.725730735,Corporate
221,18,12,6,26,8,62.3,100,5.191666667,Call Center
708,347,257,90,399,31,554.533333,94.29347826,2.157717249,Corporate
18097,17932,17885,47,17952,10,3442.3,99.94426485,0.192468549,Call Center
26436,24428,21449,2979,25204,495,121905.75,98.86276256,5.683516714,Corporate
15204,14765,14600,165,14816,15,2781.233333,99.75677319,0.190495434,Call Center
22099,11117,9917,1200,12125,542,12985.88333,95.97686264,1.309456825,Corporate
2,2,2,0,2,0,7.15,100,3.575,Corporate
8,1,1,0,2,1,2.433333,100,2.433333,Call Center
151,88,32,56,89,0,71.616667,98.87640449,2.238020844,Corporate
14,13,13,0,13,0,9.516667,100,0.732051308,Call Center
137533,66098,28247,37851,103449,28435,29747.61667,88.11421868,1.053124816,Call Center
576643,490754,450231,40523,514129,6069,663051.2833,96.5937094,1.472691315,Corporate
1,1,1,0,1,0,0.033333,100,0.033333,Corporate
1,1,1,0,1,0,1.616667,100,1.616667,Call Center
13487,12954,11335,1619,13230,177,4427.2,99.24155367,0.390577856,Call Center
107896,94129,65917,28212,99173,2620,491540.6333,97.48946175,7.456963049,Corporate
1,1,1,0,1,0,4.983333,100,4.983333,Corporate
7,2,2,0,4,1,0.333333,66.66666667,0.1666665,Call Center
1655,934,568,366,1082,22,1287.733333,88.11320755,2.26713615,Corporate
29,14,7,7,14,0,35.366667,100,5.052381,Call Center
85513,81474,77209,4265,84962,1703,34031.91667,97.85608763,0.44077655,Call Center
617332,575565,485498,90067,600988,8632,1764376.383,97.16538703,3.634157882,Corporate
42,6,6,0,8,2,69.983333,100,11.66388883,Corporate
15,10,4,6,10,0,1.766667,100,0.44166675,Call Center
6651,6320,6101,219,6377,8,1672,99.23064845,0.274053434,Call Center
28939,16629,8259,8370,18488,230,33316.68333,91.07788367,4.033985147,Corporate
4,3,2,1,3,0,26.266667,100,13.1333335,Corporate
127,1,1,0,1,0,0.633333,100,0.633333,Corporate
4636,3359,2262,1097,3708,42,1616.45,91.62575014,0.714610964,Corporate
24,9,4,5,12,3,2.2,100,0.55,Call Center
51,1,1,0,1,0,1.033333,100,1.033333,Call Center
1736,3,2,1,7,4,4.133333,100,2.0666665,Corporate
1378,733,346,387,842,71,1039.966667,95.07133593,3.005684009,Corporate
36,32,9,23,40,3,13.416667,86.48648649,1.490740778,Call Center
1169,588,224,364,648,48,756.683333,98,3.378050594,Corporate
106,23,11,12,24,1,26.583333,100,2.416666636,Call Center
520,267,171,96,368,94,687.016667,97.44525547,4.017641327,Corporate
13,10,4,6,11,1,13.666667,100,3.41666675,Call Center
999,374,202,172,490,87,1461.666667,92.80397022,7.235973599,Corporate
78,68,65,3,68,0,22.25,100,0.342307692,Call Center
81079,79557,77492,2065,80501,481,41434.9,99.42139465,0.534699066,Call Center
486417,462141,434386,27755,483650,6778,1397231.767,96.9109111,3.216567216,Corporate
12,12,12,0,12,0,14.683333,100,1.223611083,Corporate
88,31,18,13,32,0,11.95,96.875,0.663888889,Call Center
4054810,1474528,683080,791448,1745978,198921,129921.7333,95.31180816,0.190199879,Call Center
1942152,1982906,651449,1331457,2146468,48332,1835774.883,94.50798232,2.817987108,Corporate
105,37,35,2,45,8,88.1,100,2.517142857,Corporate
34,15,5,10,15,0,15.083333,100,3.0166666,Call Center
861,208,51,157,238,29,84.633333,99.5215311,1.659477118,Corporate
13358,12888,12624,264,13371,68,3820.816667,96.88040292,0.302662917,Call Center
59371,61171,36197,24974,64489,2199,358261.3667,98.20356397,9.897543074,Corporate
940,112,64,48,135,7,446.533333,87.5,6.977083328,Corporate
550,394,317,77,416,10,5345.483333,97.04433498,16.86272345,Call Center
3643,1878,917,961,3085,129,6257.25,63.53179973,6.823609597,Corporate
5,3,1,2,3,0,1.933333,100,1.933333,Call Center
21070,14332,13467,865,14754,335,9556.433333,99.39662945,0.709618574,Call Center
134749,89156,43685,45471,95087,5109,263247.7667,99.08644335,6.02604479,Corporate
1064,1055,1015,40,1055,0,23382.08333,100,23.0365353,Corporate
750,188,98,90,335,75,473.633333,72.30769231,4.832993194,Corporate
116,1,1,0,1,0,0.25,100,0.25,Corporate
46,26,1,25,38,0,0.033333,68.42105263,0.033333,Corporate
839,794,647,147,813,18,1311.083333,99.87421384,2.026403915,Call Center
12201,9650,8131,1519,10491,632,14345.8,97.88010954,1.76433403,Corporate
204,174,85,89,202,14,122.45,92.55319149,1.440588235,Call Center
7137,5177,2670,2507,5930,248,16191.73333,91.11228441,6.0643196,Corporate
2,2,2,0,2,0,4.883333,100,2.4416665,Corporate
37,31,19,12,33,2,22.316667,100,1.174561421,Call Center
22228,21438,17959,3479,21622,158,10365.05,99.87886694,0.577150732,Call Center
96628,51727,32943,18784,55286,3026,216000.0833,98.9800995,6.556782422,Corporate
25,17,13,4,29,3,56.05,65.38461538,4.311538462,Corporate
47,1,1,0,1,0,7.433333,100,7.433333,Call Center
1152,141,91,50,156,2,335.5,91.55844156,3.686813187,Corporate
615,220,3,217,222,0,7.433333,99.0990991,2.477777667,Call Center
1371,942,588,354,1044,37,1932.1,93.54518371,3.285884354,Corporate
2,2,1,1,2,0,0.316667,100,0.316667,Call Center
235,171,85,86,189,18,199.666667,100,2.349019612,Call Center
4925,3359,1875,1484,3707,72,9505.183333,92.40715268,5.069431111,Corporate
9543136,5872808,3835780,2037028,6569078,688880,1352480.033,99.87432396,0.35259583,Call Center
821002,612469,481262,131207,678464,45425,459111.25,96.75059515,0.953973615,Call Center
34519290,22349934,15089492,7260442,25560170,1540034,46741121.48,93.04665885,3.097594106,Corporate
3462,3389,3150,239,3466,52,10585.3,99.26772115,3.360412698,Corporate
9231,9208,8981,227,9284,9,2050.283333,99.27762803,0.228291207,Call Center
23801,19797,12309,7488,20662,513,152275.7167,98.25301504,12.37108755,Corporate
106392,99641,45958,53683,110931,4640,118353.25,93.74359071,2.575248053,Call Center
294976,230452,131080,99372,278677,14465,808670.2833,87.22238203,6.169288094,Corporate
70558302,58813076,41176364,17636712,60826050,1760338,35120509.18,99.57227977,0.852928859,Call Center
2339,2322,2071,251,2340,15,314.866667,99.87096774,0.152036054,Call Center
37187,5684,5193,491,5844,62,13752.81667,98.30508475,2.648337506,Corporate
16917433,15273160,10833401,4439759,15529953,174026,60542791.4,99.46100942,5.588530453,Corporate
772244,738922,674281,64641,752930,13642,12750979.85,99.95049291,18.91048369,Corporate
126,2,1,1,19,0,0.333333,10.52631579,0.333333,Corporate
296,262,184,78,286,22,156.133333,99.24242424,0.848550723,Call Center
5410,3705,3113,592,4110,310,20924.73333,97.5,6.721726095,Corporate
628,518,39,479,615,96,38.616667,99.80732177,0.990170949,Call Center
28952,26414,21704,4710,26984,333,24845.6,99.11072755,1.144747512,Corporate
77,33,13,20,33,0,68.583333,100,5.275641,Call Center
4457,1944,968,976,3449,234,5079.3,60.46656299,5.247210744,Corporate
12,6,4,2,6,0,3.15,100,0.7875,Call Center
70,18,13,5,18,0,6.583333,100,0.506410231,Call Center
1399,134,73,61,239,89,233.45,89.33333333,3.197945205,Corporate
5,3,3,0,3,0,1.05,100,0.35,Corporate
23,2,1,1,3,1,1.083333,100,1.083333,Call Center
186,33,22,11,33,0,25.533333,100,1.160606045,Call Center
11192,7125,4876,2249,7700,310,19702.15,96.41407307,4.040637818,Corporate
1,1,1,0,1,0,0.816667,100,0.816667,Corporate
36,22,13,9,24,1,8.9,95.65217391,0.684615385,Call Center
2107,1463,715,748,1641,100,3188.933333,94.93835172,4.46004662,Call Center
39585,24813,13474,11339,29903,2641,93659.3,91.01679994,6.951113255,Corporate
21,14,11,3,22,1,44.566667,66.66666667,4.051515182,Corporate
24,9,1,8,11,1,2.35,90,2.35,Call Center
1203,348,100,248,360,1,222.316667,96.93593315,2.22316667,Corporate
11272,8553,235,8318,8576,22,661.883333,99.98830956,2.816524821,Call Center
53099,44837,13750,31087,48122,1965,37163.76667,97.14019542,2.702819394,Corporate
1325,1112,30,1082,1153,37,96.05,99.64157706,3.201666667,Call Center
48929,47024,25699,21325,47652,533,83347.63333,99.79838282,3.243224769,Corporate
228854686,167416545,114409980,53006565,191883563,18165806,278702877.9,51671.71735,2013.11235,
